laua,laua_name,All Premises,All Matched Premises,SFBB availability (% premises),UFBB (100Mbit/s) availability (% premises),UFBB availability (% premises),Full Fibre availability (% premises),Gigabit availability (% premises),% of premises unable to receive 2Mbit/s,% of premises unable to receive 5Mbit/s,% of premises unable to receive 10Mbit/s,% of premises unable to receive 30Mbit/s,% of premises below the USO,% of premises with NGA,% of premises able to receive decent broadband from FWA,Number of premises with SFBB availability,Number of premises with UFBB (100Mbit/s) availability,Number of premises with UFBB availability,Number of premises with Full Fibre availability,Number of premises with Gigabit availability,Number of premises unable to receive 2Mbit/s,Number of premises unable to receive 5Mbit/s,Number of premises unable to receive 10Mbit/s,Number of premises unable to receive 30Mbit/s,Number of premises below the USO,Number of premises with NGA,Number of premises able to receive decent broadband from FWA,Number of premises with 30<300Mbit/s download speed,Number of premises with >=300Mbit/s download speed,Number of premises with 0<2Mbit/s download speed,Number of premises with 2<5Mbit/s download speed,Number of premises with 5<10Mbit/s download speed,Number of premises with 10<30Mbit/s download speed,% of premises with 30<300Mbit/s download speed,% of premises with >=300Mbit/s download speed,% of premises with 0<2Mbit/s download speed,% of premises with 2<5Mbit/s download speed,% of premises with 5<10Mbit/s download speed,% of premises with 10<30Mbit/s download speed
S12000033,ABERDEEN CITY,126176,125948,94.6,49.0,41.6,34.9,34.9,0.0,0.2,0.7,5.2,0.2,97.0,0.0,119358,61798,52461,44051,44051,55,208,881,6590,300,122434,0,66897,52461,55,153,673,5709,53.0,41.6,0.0,0.1,0.5,4.5
S12000034,ABERDEENSHIRE,126065,125176,82.9,7.2,7.0,6.9,6.9,2.6,5.6,9.1,16.4,3.6,94.7,0.0,104472,9118,8872,8732,8732,3234,7099,11516,20704,4538,119331,0,95600,8872,3234,3865,4417,9188,75.8,7.0,2.6,3.1,3.5,7.3
E07000223,ADUR,29779,29755,98.8,85.8,85.6,0.6,0.6,0.0,0.0,0.1,1.1,0.1,99.5,0.0,29427,25562,25482,189,189,0,10,34,328,33,29616,0,3945,25482,0,10,24,294,13.2,85.6,0.0,0.0,0.1,1.0
E07000026,ALLERDALE,51647,51483,92.3,2.8,2.8,2.8,2.8,1.2,2.3,3.3,7.3,1.2,98.6,2.2,47693,1466,1466,1466,1466,627,1173,1705,3790,634,50931,1160,46227,1466,627,546,532,2085,89.5,2.8,1.2,1.1,1.0,4.0
E07000032,AMBER VALLEY,61134,60972,94.7,30.2,26.7,23.6,23.6,0.1,0.5,0.9,5.1,0.4,98.9,0.0,57875,18462,16323,14438,14438,63,280,573,3097,267,60483,0,41552,16323,63,217,293,2524,68.0,26.7,0.1,0.4,0.5,4.1
S12000041,ANGUS,60856,60366,86.8,14.3,14.1,1.9,1.9,1.4,3.8,6.9,12.4,2.5,95.3,0.0,52794,8722,8599,1164,1164,856,2292,4201,7572,1501,57974,0,44195,8599,856,1436,1909,3371,72.6,14.1,1.4,2.4,3.1,5.5
N09000001,ANTRIM AND NEWTOWNABBEY,61028,60487,91.6,74.7,74.5,63.3,63.3,1.6,2.9,3.7,7.5,1.7,98.4,0.0,55911,45613,45464,38651,38651,976,1799,2284,4576,1027,60040,0,10447,45464,976,823,485,2292,17.1,74.5,1.6,1.3,0.8,3.8
N09000011,ARDS AND NORTH DOWN,72718,72511,94.7,70.6,70.4,68.6,68.6,0.6,1.2,2.1,5.0,0.9,99.5,0.0,68865,51336,51178,49862,49862,432,840,1562,3646,622,72375,0,17687,51178,432,408,722,2084,24.3,70.4,0.6,0.6,1.0,2.9
S12000035,ARGYLL AND BUTE,56475,54908,77.7,1.6,1.6,1.6,1.6,3.2,6.1,10.6,19.5,8.0,88.1,0.0,43886,885,885,884,885,1799,3419,5969,11022,4527,49764,0,43001,885,1799,1620,2550,5053,76.1,1.6,3.2,2.9,4.5,8.9
N09000002,"ARMAGH CITY, BANBRIDGE AND CRAIGAVON",86230,85774,88.3,57.2,56.4,57.2,57.2,1.5,3.1,4.9,11.2,2.1,98.3,0.2,76142,49316,48644,49315,49315,1314,2677,4200,9632,1801,84764,136,27498,48644,1314,1363,1523,5432,31.9,56.4,1.5,1.6,1.8,6.3
E07000224,ARUN,78793,78724,96.6,9.8,6.2,3.4,3.4,0.1,0.2,0.4,3.3,0.2,99.6,0.0,76086,7757,4916,2718,2718,92,138,297,2638,127,78508,0,71170,4916,92,46,159,2341,90.3,6.2,0.1,0.1,0.2,3.0
E07000170,ASHFIELD,59136,59038,98.3,87.3,86.7,3.8,3.8,0.0,0.3,0.4,1.5,0.3,99.1,0.0,58123,51610,51290,2243,2243,10,206,255,915,171,58586,0,6833,51290,10,196,49,660,11.6,86.7,0.0,0.3,0.1,1.1
E07000105,ASHFORD,58410,58257,90.0,48.4,45.3,7.5,7.5,0.4,1.8,3.6,9.7,1.1,98.3,0.0,52585,28269,26481,4361,4361,218,1023,2104,5672,641,57414,0,26104,26481,218,805,1081,3568,44.7,45.3,0.4,1.4,1.9,6.1
E07000200,BABERGH,43222,43059,93.4,12.7,12.4,8.3,8.3,0.4,0.8,1.3,6.3,0.8,98.8,0.0,40353,5478,5343,3585,3585,161,359,577,2706,341,42712,0,35010,5343,161,198,218,2129,81.0,12.4,0.4,0.5,0.5,4.9
E09000002,BARKING AND DAGENHAM,80506,80479,98.9,88.0,87.8,51.8,51.8,0.0,0.3,0.4,1.1,0.0,98.9,0.0,79605,70842,70694,41699,41699,18,236,347,874,40,79615,0,8911,70694,18,218,111,527,11.1,87.8,0.0,0.3,0.1,0.7
E09000003,BARNET,159052,158878,97.3,58.7,54.9,21.1,21.1,0.0,0.0,0.1,2.6,0.1,98.2,0.0,154750,93291,87323,33540,33540,0,17,139,4128,172,156209,0,67427,87323,0,17,122,3989,42.4,54.9,0.0,0.0,0.1,2.5
E08000016,BARNSLEY,117509,117242,97.9,69.0,65.2,22.2,22.2,0.1,0.2,0.3,1.8,0.3,99.1,0.0,115070,81060,76598,26112,26114,97,267,399,2172,295,116462,0,38472,76598,97,170,132,1773,32.7,65.2,0.1,0.1,0.1,1.5
E07000027,BARROW-IN-FURNESS,35523,35487,98.5,0.9,0.9,0.9,0.9,0.2,0.2,0.4,1.4,0.2,99.9,0.1,35002,327,327,327,327,55,82,133,485,59,35478,35,34675,327,55,27,51,352,97.6,0.9,0.2,0.1,0.1,1.0
E07000066,BASILDON,83594,83414,97.6,73.3,72.0,16.6,16.6,0.0,0.2,0.4,2.2,0.2,99.3,0.0,81596,61273,60204,13890,13890,9,128,321,1818,184,83018,0,21392,60204,9,119,193,1497,25.6,72.0,0.0,0.1,0.2,1.8
E07000084,BASINGSTOKE AND DEANE,81334,81237,96.0,53.3,51.5,19.2,51.3,0.2,0.6,1.1,3.9,0.5,98.9,0.0,78066,43348,41885,15612,41718,131,454,928,3171,434,80419,0,36181,41885,131,323,474,2243,44.5,51.5,0.2,0.4,0.6,2.8
E07000171,BASSETLAW,56518,56297,95.6,33.0,26.5,6.3,6.3,0.4,0.8,1.2,4.0,0.6,99.0,6.8,54035,18662,14980,3558,3558,229,441,694,2262,335,55980,3829,39055,14980,229,212,253,1568,69.1,26.5,0.4,0.4,0.4,2.8
E06000022,BATH AND NORTH EAST SOMERSET,88654,88497,90.9,58.5,51.6,21.0,21.0,0.3,0.7,1.7,8.9,0.6,95.0,0.0,80577,51854,45786,18607,18607,275,654,1550,7920,495,84196,0,34791,45786,275,379,896,6370,39.2,51.6,0.3,0.4,1.0,7.2
E06000055,BEDFORD,81203,81148,96.9,74.3,71.2,10.7,10.7,0.1,0.4,0.8,3.0,0.2,99.0,0.0,78724,60295,57791,8705,8705,114,360,661,2424,150,80359,0,20933,57791,114,246,301,1763,25.8,71.2,0.1,0.3,0.4,2.2
N09000003,BELFAST,166853,166159,97.7,90.9,90.5,70.3,70.3,0.0,0.1,0.4,1.9,0.4,97.9,0.0,163012,151664,150971,117322,117322,22,92,664,3147,696,163356,0,12041,150971,22,70,572,2483,7.2,90.5,0.0,0.0,0.3,1.5
E09000004,BEXLEY,103103,102966,97.6,78.5,77.4,27.0,27.0,0.0,0.1,0.6,2.3,0.2,98.1,0.0,100579,80952,79817,27793,27793,6,103,588,2387,173,101183,0,20762,79817,6,97,485,1799,20.1,77.4,0.0,0.1,0.5,1.7
E08000025,BIRMINGHAM,474257,473084,95.7,90.0,89.1,33.4,88.4,0.0,0.1,0.8,4.1,0.2,95.7,0.0,453773,427016,422455,158466,419053,27,466,3724,19311,1183,454063,0,31318,422455,27,439,3258,15587,6.6,89.1,0.0,0.1,0.7,3.3
E07000129,BLABY,45249,45185,97.7,72.5,69.4,33.6,33.6,0.1,0.3,0.4,2.1,0.2,98.8,0.0,44228,32827,31417,15210,15210,33,116,169,957,69,44710,0,12811,31417,33,83,53,788,28.3,69.4,0.1,0.2,0.1,1.7
E06000008,BLACKBURN WITH DARWEN,67236,67094,97.6,67.3,66.8,9.6,9.6,0.0,0.2,0.5,2.2,0.2,99.0,22.1,65602,45229,44933,6428,6446,26,163,326,1492,166,66567,14862,20669,44933,26,137,163,1166,30.7,66.8,0.0,0.2,0.2,1.7
E06000009,BLACKPOOL,77644,77558,98.9,70.5,70.3,0.5,0.5,0.0,0.0,0.0,1.0,0.1,99.0,0.0,76761,54725,54581,419,419,2,11,35,797,84,76902,0,22180,54581,2,9,24,762,28.6,70.3,0.0,0.0,0.0,1.0
W06000019,BLAENAU GWENT,35222,35156,96.4,5.0,3.6,2.4,2.4,0.1,0.2,0.7,3.4,0.3,99.4,0.1,33971,1769,1283,860,860,19,76,245,1185,110,34997,18,32688,1283,19,57,169,940,92.8,3.6,0.1,0.2,0.5,2.7
E07000033,BOLSOVER,38631,38563,95.1,41.8,37.0,13.6,13.6,0.1,0.2,0.4,4.7,0.2,98.8,0.0,36736,16147,14309,5257,5257,25,67,156,1827,95,38166,0,22427,14309,25,42,89,1671,58.1,37.0,0.1,0.1,0.2,4.3
E08000001,BOLTON,133212,132997,98.3,85.8,83.6,1.2,82.0,0.0,0.1,0.3,1.6,0.2,99.1,0.0,130913,114360,111395,1532,109210,35,149,440,2084,222,132047,0,19518,111395,35,114,291,1644,14.7,83.6,0.0,0.1,0.2,1.2
E07000136,BOSTON,33228,32975,90.7,4.3,4.3,4.3,4.3,0.7,1.5,2.4,8.5,1.5,97.4,2.9,30140,1418,1418,1418,1418,220,513,785,2835,511,32355,966,28722,1418,220,293,272,2050,86.4,4.3,0.7,0.9,0.8,6.2
E06000058,"BOURNEMOUTH, CHRISTCHURCH AND POOLE",197690,196755,98.2,81.4,78.7,20.1,20.1,0.2,0.2,0.3,1.3,0.5,99.0,0.0,194153,160900,155641,39637,39638,337,377,599,2602,953,195739,0,38512,155641,337,40,222,2003,19.5,78.7,0.2,0.0,0.1,1.0
E06000036,BRACKNELL FOREST,53730,53674,96.1,61.7,58.2,7.5,55.9,0.2,0.3,1.0,3.8,0.2,98.5,0.0,51651,33173,31244,4028,30037,90,182,526,2023,107,52924,0,20407,31244,90,92,344,1497,38.0,58.2,0.2,0.2,0.6,2.8
E08000032,BRADFORD,212221,211736,96.4,81.0,78.6,3.4,76.9,0.1,0.3,0.5,3.4,0.2,97.9,20.9,204623,171891,166820,7283,163109,182,583,1103,7113,521,207741,44256,37803,166820,182,401,520,6010,17.8,78.6,0.1,0.2,0.2,2.8
E07000067,BRAINTREE,70600,70403,92.2,11.8,11.8,11.7,11.7,0.6,1.6,2.7,7.5,1.4,96.2,0.0,65110,8315,8315,8278,8278,396,1148,1931,5293,1012,67890,0,56795,8315,396,752,783,3362,80.4,11.8,0.6,1.1,1.1,4.8
E07000143,BRECKLAND,66218,66050,89.8,14.0,12.3,11.1,11.1,0.7,1.8,3.0,9.9,1.7,97.5,0.0,59488,9246,8154,7335,7335,458,1187,2013,6562,1097,64565,0,51334,8154,458,729,826,4549,77.5,12.3,0.7,1.1,1.2,6.9
E09000005,BRENT,134419,133830,97.2,70.3,68.1,25.5,25.5,0.0,0.1,0.4,2.3,0.4,97.3,0.0,130690,94452,91491,34329,34329,2,71,563,3140,583,130814,0,39199,91491,2,69,492,2577,29.2,68.1,0.0,0.1,0.4,1.9
E07000068,BRENTWOOD,35550,35451,95.0,4.2,4.2,4.2,4.2,0.1,0.2,0.5,4.7,0.4,99.2,0.0,33783,1481,1480,1479,1479,34,82,160,1668,125,35257,0,32303,1480,34,48,78,1508,90.9,4.2,0.1,0.1,0.2,4.2
W06000013,BRIDGEND,67172,67097,96.7,39.4,29.2,22.5,22.5,0.0,0.1,0.8,3.2,0.1,98.6,36.6,64956,26445,19586,15104,15104,31,81,555,2141,84,66257,24577,45370,19586,31,50,474,1586,67.5,29.2,0.0,0.1,0.7,2.4
E06000043,BRIGHTON AND HOVE,141272,141002,97.7,85.0,82.0,1.9,1.9,0.0,0.1,0.5,2.1,0.2,97.9,0.0,138063,120073,115850,2693,2693,5,74,695,2939,274,138328,0,22213,115850,5,69,621,2244,15.7,82.0,0.0,0.0,0.4,1.6
E06000023,"BRISTOL, CITY OF",214819,214369,95.7,88.9,87.7,45.7,45.7,0.0,0.1,0.4,4.1,0.2,95.8,0.0,205614,191052,188333,98084,98084,6,118,886,8755,494,205897,0,17281,188333,6,112,768,7869,8.0,87.7,0.0,0.1,0.4,3.7
E07000144,BROADLAND,61616,61399,94.0,42.9,39.5,7.3,7.3,0.2,0.8,1.6,5.6,1.1,98.5,0.0,57946,26410,24363,4492,4492,147,478,984,3453,698,60694,0,33583,24363,147,331,506,2469,54.5,39.5,0.2,0.5,0.8,4.0
E09000006,BROMLEY,146343,146272,97.6,86.7,86.4,3.2,3.2,0.0,0.2,0.5,2.3,0.1,98.5,0.0,142844,126887,126456,4663,4670,55,362,720,3428,116,144220,0,16388,126456,55,307,358,2708,11.2,86.4,0.0,0.2,0.2,1.9
E07000234,BROMSGROVE,44908,44805,95.9,51.4,51.2,31.1,51.3,0.1,0.5,1.0,3.8,0.4,99.5,0.1,43078,23068,22994,13969,23034,45,239,428,1727,161,44669,53,20084,22994,45,194,189,1299,44.7,51.2,0.1,0.4,0.4,2.9
E07000095,BROXBOURNE,43029,43011,98.7,87.9,84.4,3.7,3.7,0.1,0.1,0.2,1.3,0.1,99.4,0.0,42453,37834,36312,1606,1606,26,39,94,558,24,42752,0,6141,36312,26,13,55,464,14.3,84.4,0.1,0.0,0.1,1.1
E07000172,BROXTOWE,52241,52199,98.9,89.5,84.7,1.3,1.3,0.0,0.1,0.2,1.1,0.1,99.6,0.0,51642,46755,44223,692,692,14,48,102,557,41,52029,0,7419,44223,14,34,54,455,14.2,84.7,0.0,0.1,0.1,0.9
E06000060,BUCKINGHAMSHIRE,239525,239115,93.9,46.3,40.7,8.8,14.4,0.2,0.7,1.7,6.0,0.4,98.2,0.0,224852,110784,97444,21144,34591,469,1713,4092,14263,1019,235115,0,127408,97444,469,1244,2379,10171,53.2,40.7,0.2,0.5,1.0,4.2
E07000117,BURNLEY,45261,45163,98.1,78.8,78.7,0.9,78.7,0.1,0.1,0.3,1.7,0.2,99.4,4.5,44403,35650,35633,406,35632,34,52,133,760,112,44983,2015,8770,35633,34,18,81,627,19.4,78.7,0.1,0.0,0.2,1.4
E08000002,BURY,88685,88206,97.4,60.4,54.3,23.7,49.9,0.0,0.1,0.2,2.1,0.5,99.3,0.0,86340,53574,48196,21004,44224,14,90,174,1866,479,88100,0,38144,48196,14,76,84,1692,43.0,54.3,0.0,0.1,0.1,1.9
W06000018,CAERPHILLY,83037,82981,97.8,25.3,19.7,16.0,16.0,0.1,0.1,0.2,2.1,0.1,99.8,47.2,81247,21009,16327,13299,13300,42,89,190,1734,59,82831,39176,64920,16327,42,47,101,1544,78.2,19.7,0.1,0.1,0.1,1.9
E08000033,CALDERDALE,103760,103570,95.0,49.2,48.7,10.6,10.6,0.1,0.4,0.8,4.8,0.2,98.7,0.0,98614,51031,50539,11028,11029,100,387,792,4956,243,102447,3,48075,50539,100,287,405,4164,46.3,48.7,0.1,0.3,0.4,4.0
E07000008,CAMBRIDGE,60809,60734,98.4,89.3,86.6,20.3,20.3,0.0,0.0,0.2,1.4,0.1,98.5,0.4,59865,54283,52671,12362,12362,1,18,116,869,75,59901,269,7194,52671,1,17,98,753,11.8,86.6,0.0,0.0,0.2,1.2
E09000007,CAMDEN,120982,120376,96.4,88.7,86.8,28.2,28.2,0.0,0.0,0.0,3.1,0.5,96.4,0.0,116644,107289,105026,34171,34171,0,0,44,3732,597,116648,0,11618,105026,0,0,44,3688,9.6,86.8,0.0,0.0,0.0,3.0
E07000192,CANNOCK CHASE,47331,47279,97.9,24.8,24.7,3.2,24.5,0.0,0.1,0.1,2.0,0.2,99.6,0.0,46322,11720,11676,1517,11608,11,34,40,957,71,47143,0,34646,11676,11,23,6,917,73.2,24.7,0.0,0.0,0.0,1.9
E07000106,CANTERBURY,73626,73389,93.6,4.5,4.5,4.5,4.5,0.3,0.7,1.3,6.1,0.6,99.3,0.0,68916,3287,3287,3287,3287,194,486,938,4473,424,73078,0,65629,3287,194,292,452,3535,89.1,4.5,0.3,0.4,0.6,4.8
W06000015,CARDIFF,165673,165476,97.7,85.6,82.8,43.7,43.7,0.0,0.1,0.5,2.2,0.1,98.2,62.5,161914,141809,137158,72385,72385,37,222,776,3562,199,162771,103611,24756,137158,37,185,554,2786,14.9,82.8,0.0,0.1,0.3,1.7
E07000028,CARLISLE,57063,56848,93.7,54.3,47.8,5.4,5.4,0.8,1.6,3.2,5.9,1.5,97.3,0.1,53486,30960,27282,3071,3071,449,907,1828,3362,845,55513,36,26204,27282,449,458,921,1534,45.9,47.8,0.8,0.8,1.6,2.7
W06000010,CARMARTHENSHIRE,92966,92355,86.5,19.1,19.1,19.1,19.1,2.0,4.4,6.8,12.9,2.4,93.5,12.6,80382,17725,17725,17721,17721,1858,4061,6313,11973,2259,86959,11739,62657,17725,1858,2203,2252,5660,67.4,19.1,2.0,2.4,2.4,6.1
E07000069,CASTLE POINT,41031,40805,98.5,43.6,43.6,2.2,2.2,0.0,0.2,0.3,0.9,0.6,99.2,0.0,40416,17904,17888,917,917,4,82,115,389,226,40687,0,22528,17888,4,78,33,274,54.9,43.6,0.0,0.2,0.1,0.7
N09000004,CAUSEWAY COAST AND GLENS,66093,64700,85.3,41.1,41.1,41.1,41.1,2.4,4.4,6.1,12.6,3.9,97.2,0.0,56400,27149,27132,27143,27143,1568,2927,4003,8300,2561,64261,0,29268,27132,1568,1359,1076,4297,44.3,41.1,2.4,2.1,1.6,6.5
E06000056,CENTRAL BEDFORDSHIRE,126575,126444,96.7,67.2,64.0,12.5,12.5,0.1,0.6,1.0,3.2,0.3,98.9,0.0,122365,85060,81035,15863,15863,128,756,1311,4079,331,125218,0,41330,81035,128,628,555,2768,32.7,64.0,0.1,0.5,0.4,2.2
W06000008,CEREDIGION,37566,37319,80.3,20.0,20.0,20.0,20.0,3.0,7.1,11.7,19.0,4.6,89.0,3.4,30170,7528,7528,7528,7528,1143,2661,4389,7149,1738,33450,1262,22642,7528,1143,1518,1728,2760,60.3,20.0,3.0,4.0,4.6,7.3
E07000130,CHARNWOOD,79210,78928,98.0,74.2,70.9,9.9,9.9,0.1,0.2,0.4,1.7,0.4,99.1,0.0,77607,58749,56197,7860,7860,82,170,355,1321,320,78483,0,21410,56197,82,88,185,966,27.0,70.9,0.1,0.1,0.2,1.2
E07000070,CHELMSFORD,81992,81900,94.8,59.8,56.5,32.1,32.1,0.1,0.3,0.8,5.1,0.2,98.4,0.0,77735,49027,46292,26353,26353,59,277,631,4165,185,80653,0,31443,46292,59,218,354,3534,38.3,56.5,0.1,0.3,0.4,4.3
E07000078,CHELTENHAM,60127,59974,98.6,76.5,69.5,5.5,5.5,0.0,0.1,0.2,1.1,0.3,99.1,0.0,59296,45994,41771,3309,3309,15,55,150,678,160,59575,0,17525,41771,15,40,95,528,29.1,69.5,0.0,0.1,0.2,0.9
E07000177,CHERWELL,71032,70870,96.4,47.9,38.5,10.5,10.5,0.2,0.4,1.0,3.4,0.4,98.7,0.0,68481,33999,27372,7423,7423,170,287,689,2389,252,70102,0,41109,27372,170,117,402,1700,57.9,38.5,0.2,0.2,0.6,2.4
E06000049,CHESHIRE EAST,188856,188555,93.4,45.0,38.2,9.2,17.2,0.3,0.9,1.6,6.5,0.4,98.3,1.5,176336,84908,72146,17285,32425,609,1642,3103,12219,745,185627,2776,104190,72146,609,1033,1461,9116,55.2,38.2,0.3,0.5,0.8,4.8
E06000050,CHESHIRE WEST AND CHESTER,169227,168988,95.0,45.1,38.1,19.8,19.8,0.2,0.6,1.2,4.9,0.3,98.9,0.5,160748,76292,64550,33451,33451,284,1026,2024,8240,444,167343,774,96198,64550,284,742,998,6216,56.8,38.1,0.2,0.4,0.6,3.7
E07000034,CHESTERFIELD,53216,53157,97.4,53.5,40.8,22.4,22.4,0.0,0.0,0.2,2.5,0.1,99.4,0.0,51818,28449,21735,11903,11903,0,13,122,1339,61,52892,0,30083,21735,0,13,109,1217,56.5,40.8,0.0,0.0,0.2,2.3
E07000225,CHICHESTER,61965,61578,90.6,22.7,20.7,19.2,19.2,0.4,1.0,2.2,8.7,1.4,98.5,0.0,56164,14079,12820,11920,11920,219,608,1357,5414,879,61049,0,43344,12820,219,389,749,4057,69.9,20.7,0.4,0.6,1.2,6.5
E07000118,CHORLEY,54566,54425,95.6,58.9,55.0,11.5,11.5,0.1,0.2,0.8,4.2,0.3,99.1,5.2,52156,32166,29996,6254,6255,30,133,412,2269,174,54070,2861,22160,29996,30,103,279,1857,40.6,55.0,0.1,0.2,0.5,3.4
S12000036,CITY OF EDINBURGH,265092,264996,97.7,86.3,84.5,39.3,82.9,0.0,0.2,0.4,2.3,0.1,98.1,0.0,258940,228835,223920,104191,219845,107,474,945,6056,143,260018,0,35020,223920,107,367,471,5111,13.2,84.5,0.0,0.1,0.2,1.9
E09000001,CITY OF LONDON,11008,10982,56.5,46.9,46.3,45.7,45.7,0.0,0.0,0.0,43.3,0.2,56.5,0.0,6219,5166,5093,5026,5026,0,0,0,4763,26,6219,0,1126,5093,0,0,0,4763,10.2,46.3,0.0,0.0,0.0,43.3
S12000005,CLACKMANNANSHIRE,25820,25641,93.8,19.5,7.6,2.7,2.7,0.1,0.2,0.4,5.5,0.8,99.1,0.0,24232,5027,1958,693,693,28,47,96,1409,205,25587,0,22274,1958,28,19,49,1313,86.3,7.6,0.1,0.1,0.2,5.1
E07000071,COLCHESTER,87697,87080,94.0,54.0,53.8,9.1,9.1,0.2,1.0,1.9,5.3,1.3,96.3,0.0,82424,47392,47224,7954,7954,194,890,1674,4656,1166,84466,0,35200,47224,194,696,784,2982,40.1,53.8,0.2,0.8,0.9,3.4
W06000003,CONWY,59312,59245,93.3,7.2,7.2,7.2,7.2,0.8,2.0,3.3,6.6,1.1,97.4,58.5,55360,4289,4289,4289,4289,477,1179,1938,3885,681,57783,34684,51071,4289,477,702,759,1947,86.1,7.2,0.8,1.2,1.3,3.3
E07000029,COPELAND,35682,35588,94.8,1.6,1.6,1.6,1.6,0.3,0.8,1.5,4.9,1.0,99.0,0.0,33827,554,554,554,554,119,274,532,1761,353,35342,0,33273,554,119,155,258,1229,93.2,1.6,0.3,0.4,0.7,3.4
E07000150,CORBY,32478,32397,98.1,78.1,64.9,23.6,23.6,0.1,0.2,0.3,1.6,0.4,98.6,0.0,31864,25373,21081,7681,7681,20,81,105,533,128,32027,0,10783,21081,20,61,24,428,33.2,64.9,0.1,0.2,0.1,1.3
E06000052,CORNWALL,299232,297717,88.2,35.7,34.3,31.4,31.4,0.3,1.0,2.2,11.3,1.0,93.5,3.0,263839,106799,102716,93817,93817,893,2943,6597,33878,3137,279674,8995,161123,102716,893,2050,3654,27281,53.8,34.3,0.3,0.7,1.2,9.1
E07000079,COTSWOLD,47123,47022,92.1,36.8,36.7,36.5,36.5,0.2,0.8,1.9,7.7,1.0,94.3,0.1,43380,17358,17279,17220,17220,79,364,898,3642,462,44456,67,26101,17279,79,285,534,2744,55.4,36.7,0.2,0.6,1.1,5.8
E06000047,COUNTY DURHAM,259566,259080,93.7,23.9,19.5,15.3,15.3,0.3,0.8,1.4,6.1,0.5,98.8,0.2,243295,62087,50616,39592,39592,874,2034,3691,15785,1357,256385,634,192679,50616,874,1160,1657,12094,74.2,19.5,0.3,0.4,0.6,4.7
E08000026,COVENTRY,148514,148034,97.6,89.5,89.3,67.2,89.3,0.0,0.3,0.6,2.1,0.3,97.8,0.0,144941,132896,132645,99798,132696,7,458,855,3093,477,145217,0,12296,132645,7,451,397,2238,8.3,89.3,0.0,0.3,0.3,1.5
E07000163,CRAVEN,30055,29952,92.1,22.4,17.0,11.7,11.8,1.0,2.0,3.2,7.5,0.9,97.5,34.2,27685,6722,5110,3524,3537,312,600,962,2267,268,29299,10266,22575,5110,312,288,362,1305,75.1,17.0,1.0,1.0,1.2,4.3
E07000226,CRAWLEY,49058,48883,98.6,84.6,84.0,3.0,3.0,0.0,0.1,0.2,1.0,0.4,99.1,0.0,48383,41525,41222,1448,1448,10,35,89,500,183,48620,0,7161,41222,10,25,54,411,14.6,84.0,0.0,0.1,0.1,0.8
E09000008,CROYDON,168000,167241,96.0,84.1,83.0,19.8,19.8,0.0,0.0,0.2,3.6,0.5,96.6,0.0,161231,141216,139427,33345,33345,1,58,393,6010,761,162222,0,21804,139427,1,57,335,5617,13.0,83.0,0.0,0.0,0.2,3.3
E07000096,DACORUM,68543,68455,96.6,77.5,74.9,4.6,4.6,0.1,0.4,0.7,3.3,0.3,99.0,0.0,66211,53143,51336,3133,3133,54,281,514,2244,175,67862,0,14875,51336,54,227,233,1730,21.7,74.9,0.1,0.3,0.3,2.5
E06000005,DARLINGTON,54518,54434,94.2,83.4,82.9,2.2,2.2,0.7,2.0,3.3,5.6,0.4,95.8,22.5,51369,45472,45212,1205,1205,361,1066,1772,3065,228,52205,12264,6157,45212,361,705,706,1293,11.3,82.9,0.7,1.3,1.3,2.4
E07000107,DARTFORD,49187,49159,95.9,54.3,50.7,14.7,14.7,0.2,0.6,1.4,4.0,0.1,98.3,0.0,47179,26688,24942,7225,7225,94,282,674,1980,37,48338,0,22237,24942,94,188,392,1306,45.2,50.7,0.2,0.4,0.8,2.7
E07000151,DAVENTRY,38116,38067,94.7,36.9,31.0,25.6,25.6,0.3,0.9,1.9,5.1,0.3,97.6,0.0,36109,14065,11823,9759,9759,109,358,743,1958,124,37211,0,24286,11823,109,249,385,1215,63.7,31.0,0.3,0.7,1.0,3.2
W06000004,DENBIGHSHIRE,49521,49300,90.2,8.0,8.0,8.0,8.0,0.8,1.9,4.2,9.4,1.2,94.7,30.8,44661,3969,3969,3969,3969,393,958,2078,4639,598,46920,15261,40692,3969,393,565,1120,2561,82.2,8.0,0.8,1.1,2.3,5.2
E06000015,DERBY,119005,118450,98.8,88.7,87.9,9.6,9.6,0.0,0.0,0.1,0.7,0.5,99.1,0.0,117607,105541,104576,11417,11456,1,15,124,843,555,117910,0,13031,104576,1,14,109,719,10.9,87.9,0.0,0.0,0.1,0.6
E07000035,DERBYSHIRE DALES,37293,37189,88.4,7.7,7.7,7.7,7.7,0.5,2.0,4.4,11.3,1.5,96.3,0.0,32965,2855,2855,2855,2855,189,755,1651,4224,573,35924,0,30110,2855,189,566,896,2573,80.7,7.7,0.5,1.5,2.4,6.9
N09000005,DERRY CITY AND STRABANE,62612,62353,90.8,73.1,73.1,53.1,53.1,2.3,3.6,4.8,8.8,2.7,98.7,0.0,56833,45791,45763,33217,33217,1433,2265,3014,5520,1705,61828,0,11070,45763,1433,832,749,2506,17.7,73.1,2.3,1.3,1.2,4.0
E08000017,DONCASTER,146389,146225,97.5,57.3,56.9,25.2,25.2,0.1,0.3,0.5,2.4,0.1,99.0,14.6,142715,83810,83348,36892,36893,110,427,778,3510,217,144899,21405,59367,83348,110,317,351,2732,40.6,56.9,0.1,0.2,0.2,1.9
E06000059,DORSET,189611,188878,92.2,9.5,8.9,6.3,6.3,0.3,0.9,1.7,7.4,0.8,98.2,7.6,174867,17955,16796,11885,11885,503,1751,3283,14011,1589,186169,14333,158071,16796,503,1248,1532,10728,83.4,8.9,0.3,0.7,0.8,5.7
E07000108,DOVER,55531,55436,92.8,30.9,30.9,4.2,4.2,0.6,1.0,2.1,7.0,0.4,98.4,0.0,51555,17150,17146,2322,2322,311,564,1139,3881,231,54646,0,34409,17146,311,253,575,2742,62.0,30.9,0.6,0.5,1.0,4.9
E08000027,DUDLEY,147285,147064,99.1,91.0,89.8,1.9,82.8,0.0,0.0,0.1,0.8,0.1,99.5,4.4,145902,133991,132257,2793,121932,2,14,77,1162,219,146477,6487,13645,132257,2,12,63,1085,9.3,89.8,0.0,0.0,0.0,0.7
S12000006,DUMFRIES AND GALLOWAY,82541,81639,84.9,6.4,6.4,6.4,6.4,1.7,3.9,6.8,14.0,3.5,96.0,0.0,70057,5243,5242,5242,5242,1410,3230,5604,11582,2853,79273,0,64815,5242,1410,1820,2374,5978,78.5,6.4,1.7,2.2,2.9,7.2
S12000042,DUNDEE CITY,79398,79360,98.4,87.1,84.8,0.9,0.9,0.0,0.0,0.3,1.6,0.0,99.0,0.0,78103,69187,67305,741,741,1,16,241,1257,39,78575,0,10798,67305,1,15,225,1016,13.6,84.8,0.0,0.0,0.3,1.3
E09000009,EALING,147941,147807,98.4,75.4,73.6,15.8,15.8,0.0,0.0,0.4,1.5,0.1,98.5,0.0,145620,111566,108880,23397,23397,0,39,527,2187,121,145659,0,36740,108880,0,39,488,1660,24.8,73.6,0.0,0.0,0.3,1.1
S12000008,EAST AYRSHIRE,60338,60248,95.5,44.7,44.1,35.0,35.0,0.6,1.2,1.9,4.4,0.4,98.7,0.0,57622,26982,26590,21117,21117,354,715,1153,2626,249,59557,0,31032,26590,354,361,438,1473,51.4,44.1,0.6,0.6,0.7,2.4
E07000009,EAST CAMBRIDGESHIRE,39753,39477,94.1,42.6,36.1,13.6,13.6,0.5,1.1,1.8,5.2,0.9,98.7,30.3,37391,16922,14353,5415,5415,198,426,704,2086,350,39226,12062,23038,14353,198,228,278,1382,58.0,36.1,0.5,0.6,0.7,3.5
E07000040,EAST DEVON,74455,74282,87.1,17.1,13.3,10.2,10.2,0.5,2.4,5.0,12.7,0.9,95.4,14.7,64848,12702,9866,7595,7595,388,1800,3734,9434,704,71014,10915,54982,9866,388,1412,1934,5700,73.8,13.3,0.5,1.9,2.6,7.7
S12000045,EAST DUNBARTONSHIRE,49419,49359,96.8,78.6,77.4,17.9,76.6,0.1,0.2,0.5,3.1,0.1,98.9,0.0,47850,38832,38253,8864,37846,25,93,246,1509,74,48867,0,9597,38253,25,68,153,1263,19.4,77.4,0.1,0.1,0.3,2.6
E07000085,EAST HAMPSHIRE,57567,57259,92.4,41.6,37.9,11.0,11.0,0.2,0.6,1.4,7.1,1.0,97.2,0.0,53189,23961,21810,6358,6358,121,371,782,4070,559,55980,0,31379,21810,121,250,411,3288,54.5,37.9,0.2,0.4,0.7,5.7
E07000242,EAST HERTFORDSHIRE,66547,66500,95.6,68.7,65.5,9.2,9.2,0.1,0.5,0.9,4.3,0.4,98.2,0.0,63628,45699,43601,6093,6093,99,324,609,2872,240,65337,0,20027,43601,99,225,285,2263,30.1,65.5,0.1,0.3,0.4,3.4
E07000137,EAST LINDSEY,72452,72070,87.6,18.9,15.1,3.8,3.8,0.9,2.7,5.0,11.9,2.4,97.2,11.0,63435,13686,10905,2765,2765,647,1939,3597,8635,1736,70444,7953,52530,10905,647,1292,1658,5038,72.5,15.1,0.9,1.8,2.3,7.0
S12000010,EAST LOTHIAN,48818,48698,92.5,24.4,23.7,24.4,24.4,0.4,1.4,2.5,7.3,0.4,97.6,41.4,45147,11926,11593,11925,11926,196,698,1198,3551,211,47656,20232,33554,11593,196,502,500,2353,68.7,23.7,0.4,1.0,1.0,4.8
E07000152,EAST NORTHAMPTONSHIRE,43066,43030,97.9,57.9,57.6,13.1,13.1,0.1,0.3,0.5,2.0,0.3,99.0,0.0,42173,24915,24807,5626,5626,30,109,210,857,123,42631,1,17366,24807,30,79,101,647,40.3,57.6,0.1,0.2,0.2,1.5
S12000011,EAST RENFREWSHIRE,41004,40988,95.9,70.6,69.9,7.1,69.8,0.1,0.2,0.5,4.1,0.1,98.9,0.0,39325,28937,28652,2892,28621,35,95,224,1663,44,40551,0,10673,28652,35,60,129,1439,26.0,69.9,0.1,0.1,0.3,3.5
E06000011,EAST RIDING OF YORKSHIRE,165585,164686,95.4,50.7,49.4,48.4,48.4,0.4,0.9,1.5,4.0,0.3,98.6,33.4,158049,84020,81746,80167,80167,733,1566,2483,6637,443,163208,55280,76303,81746,733,833,917,4154,46.1,49.4,0.4,0.5,0.6,2.5
E07000193,EAST STAFFORDSHIRE,55632,55464,94.6,33.1,28.9,24.3,24.3,0.3,0.8,1.5,5.1,0.6,98.6,0.0,52631,18390,16064,13515,13515,153,426,831,2833,322,54872,0,36567,16064,153,273,405,2002,65.7,28.9,0.3,0.5,0.7,3.6
E07000244,EAST SUFFOLK,126763,126492,94.0,19.2,19.2,12.8,12.8,0.2,0.7,1.4,5.7,0.7,98.5,0.0,119211,24340,24296,16177,16177,235,842,1740,7281,834,124874,0,94915,24296,235,607,898,5541,74.9,19.2,0.2,0.5,0.7,4.4
E07000061,EASTBOURNE,50785,50756,98.7,3.0,3.0,3.0,3.0,0.0,0.0,0.1,1.2,0.1,99.4,0.0,50139,1527,1527,1527,1527,1,7,58,617,31,50486,0,48612,1527,1,6,51,559,95.7,3.0,0.0,0.0,0.1,1.1
E07000086,EASTLEIGH,60411,60333,97.7,74.9,65.5,15.2,21.3,0.0,0.0,0.1,2.2,0.1,99.2,0.0,59006,45241,39541,9189,12860,0,0,59,1327,80,59929,0,19465,39541,0,0,59,1268,32.2,65.5,0.0,0.0,0.1,2.1
E07000030,EDEN,29810,29631,80.9,4.9,4.9,4.9,4.9,4.1,8.0,10.8,18.5,2.5,95.0,4.8,24102,1451,1451,1451,1451,1219,2382,3218,5529,741,28330,1417,22651,1451,1219,1163,836,2311,76.0,4.9,4.1,3.9,2.8,7.8
E07000207,ELMBRIDGE,60588,60483,98.7,78.3,75.9,4.5,4.5,0.0,0.0,0.1,1.2,0.2,99.7,0.0,59774,47453,45996,2742,2742,11,24,53,709,102,60402,0,13778,45996,11,13,29,656,22.7,75.9,0.0,0.0,0.0,1.1
E09000010,ENFIELD,132883,131750,97.2,88.0,86.8,2.9,2.9,0.0,0.1,0.5,1.9,0.9,97.6,0.0,129193,116910,115389,3836,3836,30,116,633,2557,1174,129668,0,13804,115389,30,86,517,1924,10.4,86.8,0.0,0.1,0.4,1.4
E07000072,EPPING FOREST,61351,61257,94.3,77.8,76.2,12.3,12.3,0.1,0.5,1.3,5.6,0.4,96.6,0.0,57834,47760,46777,7559,7559,76,280,793,3423,244,59258,0,11057,46777,76,204,513,2630,18.0,76.2,0.1,0.3,0.8,4.3
E07000208,EPSOM AND EWELL,33212,33188,99.5,90.4,90.2,60.2,60.2,0.0,0.1,0.2,0.4,0.2,99.7,0.0,33043,30021,29970,19996,19996,0,42,54,145,51,33097,0,3073,29970,0,42,12,91,9.3,90.2,0.0,0.1,0.0,0.3
E07000036,EREWASH,55744,55643,98.0,75.9,74.5,1.1,1.1,0.1,0.3,0.4,1.8,0.2,99.5,0.0,54650,42332,41507,601,601,63,189,240,993,104,55440,0,13143,41507,63,126,51,753,23.6,74.5,0.1,0.2,0.1,1.4
E07000041,EXETER,58109,58026,96.0,87.0,86.6,62.4,62.4,0.1,0.2,1.4,3.8,0.2,96.6,33.8,55805,50561,50306,36286,36286,31,116,819,2221,102,56151,19639,5499,50306,31,85,703,1402,9.5,86.6,0.1,0.1,1.2,2.4
S12000014,FALKIRK,73926,73870,96.8,83.9,83.7,8.2,83.6,0.1,0.4,1.0,3.1,0.3,98.7,0.0,71597,61998,61860,6053,61788,67,319,725,2273,193,72933,0,9737,61860,67,252,406,1548,13.2,83.7,0.1,0.3,0.5,2.1
E07000087,FAREHAM,52634,52577,98.3,86.2,83.7,5.3,5.3,0.0,0.2,0.4,1.6,0.1,99.5,0.0,51733,45392,44073,2766,2809,7,91,227,844,58,52347,0,7660,44073,7,84,136,617,14.6,83.7,0.0,0.2,0.3,1.2
E07000010,FENLAND,47899,47831,94.3,58.4,58.1,29.1,29.1,0.3,0.9,1.5,5.6,0.5,98.6,5.8,45157,27967,27851,13960,13960,166,445,738,2674,222,47214,2783,17306,27851,166,279,293,1936,36.1,58.1,0.3,0.6,0.6,4.0
N09000006,FERMANAGH AND OMAGH,50041,49182,68.9,25.5,25.5,25.5,25.5,8.4,13.8,18.6,29.4,5.1,97.0,39.9,34454,12766,12766,12766,12766,4196,6892,9308,14728,2532,48535,19968,21688,12766,4196,2696,2416,5420,43.3,25.5,8.4,5.4,4.8,10.8
S12000047,FIFE,190085,189717,95.6,51.9,51.3,23.0,23.0,0.2,0.7,1.4,4.2,0.4,98.9,0.0,181687,98671,97440,43695,43695,459,1362,2674,8030,729,188033,0,84247,97440,459,903,1312,5356,44.3,51.3,0.2,0.5,0.7,2.8
W06000005,FLINTSHIRE,73951,73816,93.8,30.8,23.0,18.4,18.4,0.4,1.2,2.6,6.0,0.5,97.5,39.7,69367,22782,16990,13613,13613,308,875,1919,4449,392,72091,29350,52377,16990,308,567,1044,2530,70.8,23.0,0.4,0.8,1.4,3.4
E07000112,FOLKESTONE AND HYTHE,54359,54306,93.2,41.2,41.0,5.3,5.3,0.5,1.2,2.3,6.7,0.4,97.9,0.0,50685,22375,22275,2898,2898,253,647,1259,3621,209,53228,0,28410,22275,253,394,612,2362,52.3,41.0,0.5,0.7,1.1,4.3
E07000080,FOREST OF DEAN,41527,41403,79.8,21.7,19.2,17.5,17.5,0.6,3.0,7.9,19.9,2.4,88.7,1.7,33123,9032,7990,7256,7256,245,1252,3289,8280,1000,36845,702,25133,7990,245,1007,2037,4991,60.5,19.2,0.6,2.4,4.9,12.0
E07000119,FYLDE,36571,36331,93.3,44.2,33.5,5.4,5.5,0.1,0.3,0.9,6.0,0.7,98.0,0.0,34122,16177,12256,1980,2002,25,116,322,2209,241,35842,7,21866,12256,25,91,206,1887,59.8,33.5,0.1,0.2,0.6,5.2
E08000037,GATESHEAD,100811,100491,95.6,71.0,69.2,4.1,4.1,0.1,0.3,1.1,4.0,0.4,97.3,0.0,96409,71546,69803,4168,4168,58,291,1152,4082,356,98131,1,26606,69803,58,233,861,2930,26.4,69.2,0.1,0.2,0.9,2.9
E07000173,GEDLING,55134,55031,98.8,88.6,87.7,36.4,36.4,0.0,0.2,0.3,1.0,0.2,99.7,0.0,54474,48845,48341,20079,20079,25,117,152,557,128,54953,0,6133,48341,25,92,35,405,11.1,87.7,0.0,0.2,0.1,0.7
S12000049,GLASGOW CITY,335271,334713,97.2,69.4,63.7,14.7,57.9,0.0,0.1,0.3,2.7,0.2,97.6,0.0,325823,232841,213475,49200,194039,63,190,874,8890,562,327216,0,112348,213475,63,127,684,8016,33.5,63.7,0.0,0.0,0.2,2.4
E07000081,GLOUCESTER,59898,59862,98.7,85.9,85.1,7.9,7.9,0.0,0.1,0.4,1.2,0.1,99.2,0.0,59114,51482,50962,4747,4747,1,48,222,748,50,59407,0,8152,50962,1,47,174,526,13.6,85.1,0.0,0.1,0.3,0.9
E07000088,GOSPORT,38821,38805,99.6,84.7,84.4,1.5,1.5,0.0,0.0,0.0,0.3,0.0,99.9,0.0,38680,32892,32783,564,564,1,9,9,125,16,38795,0,5897,32783,1,8,0,116,15.2,84.4,0.0,0.0,0.0,0.3
E07000109,GRAVESHAM,45112,45040,96.0,71.1,64.8,6.4,6.4,0.0,0.3,0.6,3.9,0.3,98.6,0.0,43298,32075,29245,2908,2908,22,129,286,1742,128,44460,0,14053,29245,22,107,157,1456,31.2,64.8,0.0,0.2,0.3,3.2
E07000145,GREAT YARMOUTH,49281,49082,97.0,50.1,50.1,3.3,3.3,0.0,0.2,0.4,2.6,0.5,99.3,0.0,47815,24701,24691,1625,1625,9,74,175,1267,234,48943,0,23124,24691,9,65,101,1092,46.9,50.1,0.0,0.1,0.2,2.2
E09000011,GREENWICH,124918,124739,98.1,81.3,74.9,19.9,19.9,0.0,0.1,0.6,1.8,0.1,98.2,0.0,122509,101577,93571,24863,24863,0,181,797,2230,180,122665,0,28938,93571,0,181,616,1433,23.2,74.9,0.0,0.1,0.5,1.1
E07000209,GUILDFORD,58401,58355,96.2,68.1,65.0,2.7,2.7,0.1,0.2,0.6,3.7,0.2,99.2,0.0,56203,39776,37943,1582,1583,32,109,373,2152,125,57932,0,18260,37943,32,77,264,1779,31.3,65.0,0.1,0.1,0.5,3.0
W06000002,GWYNEDD,67845,67496,87.2,18.3,16.8,15.7,15.7,1.3,3.4,5.9,12.3,2.2,93.4,17.7,59129,12438,11379,10643,10643,878,2274,4008,8367,1462,63387,12015,47750,11379,878,1396,1734,4359,70.4,16.8,1.3,2.1,2.6,6.4
E09000012,HACKNEY,125555,125009,97.2,76.4,71.8,18.9,18.9,0.0,0.0,0.2,2.4,0.4,97.2,0.0,122048,95888,90111,23699,23699,0,0,236,2961,543,122070,0,31937,90111,0,0,236,2725,25.4,71.8,0.0,0.0,0.2,2.2
E06000006,HALTON,61997,61791,97.6,66.1,65.3,2.2,2.9,0.0,0.1,0.4,2.0,0.3,99.2,0.0,60521,40995,40501,1357,1808,17,82,240,1270,208,61487,0,20020,40501,17,65,158,1030,32.3,65.3,0.0,0.1,0.3,1.7
E07000164,HAMBLETON,44418,44289,89.1,7.2,6.4,6.2,6.2,1.4,3.3,5.4,10.6,1.1,97.7,31.8,39597,3187,2864,2736,2736,605,1455,2412,4692,487,43409,14116,36733,2864,605,850,957,2280,82.7,6.4,1.4,1.9,2.2,5.1
E09000013,HAMMERSMITH AND FULHAM,92486,92239,94.8,69.6,57.8,23.5,23.5,0.0,0.1,0.2,4.9,0.3,94.9,0.0,87706,64404,53428,21729,21763,0,63,206,4533,242,87728,0,34278,53428,0,63,143,4327,37.1,57.8,0.0,0.1,0.2,4.7
E07000131,HARBOROUGH,42737,42683,95.0,40.6,35.2,12.8,12.8,0.3,0.7,1.4,4.9,0.5,98.6,0.0,40597,17348,15028,5476,5476,132,285,602,2086,212,42136,0,25569,15028,132,153,317,1484,59.8,35.2,0.3,0.4,0.7,3.5
E09000014,HARINGEY,109448,109349,98.4,84.2,82.8,2.8,2.8,0.0,0.0,0.3,1.6,0.1,98.5,0.0,107646,92145,90577,3113,3113,0,12,283,1703,99,107756,0,17069,90577,0,12,271,1420,15.6,82.8,0.0,0.0,0.2,1.3
E07000073,HARLOW,41354,41181,96.5,90.0,88.3,5.3,5.3,0.0,0.1,0.5,3.1,0.4,96.7,0.0,39901,37218,36535,2174,2174,1,36,192,1280,174,39970,0,3366,36535,1,35,156,1088,8.1,88.3,0.0,0.1,0.4,2.6
E07000165,HARROGATE,77777,77613,91.8,55.9,54.0,5.4,5.5,0.9,2.0,2.9,8.0,0.8,97.5,6.6,71427,43501,42005,4208,4260,670,1531,2259,6186,659,75796,5102,29422,42005,670,861,728,3927,37.8,54.0,0.9,1.1,0.9,5.0
E09000015,HARROW,98791,98485,97.5,78.9,78.7,15.0,15.0,0.0,0.0,0.5,2.2,0.3,97.7,0.0,96338,77936,77770,14867,14867,14,47,519,2147,335,96479,0,18568,77770,14,33,472,1628,18.8,78.7,0.0,0.0,0.5,1.6
E07000089,HART,44111,43816,94.8,61.4,61.3,8.7,8.7,0.1,0.7,1.1,4.5,0.8,98.4,0.0,41818,27088,27055,3833,3833,25,288,477,1998,364,43395,0,14763,27055,25,263,189,1521,33.5,61.3,0.1,0.6,0.4,3.4
E06000001,HARTLEPOOL,47166,46976,96.1,88.0,87.9,3.1,3.1,0.3,0.5,1.2,3.5,0.4,96.7,0.0,45328,41524,41472,1443,1443,140,250,544,1648,200,45610,0,3856,41472,140,110,294,1104,8.2,87.9,0.3,0.2,0.6,2.3
E07000062,HASTINGS,46130,46052,98.3,3.2,3.2,3.2,3.2,0.0,0.0,0.0,1.6,0.2,99.7,0.0,45331,1471,1471,1471,1471,0,10,12,721,78,46002,0,43860,1471,0,10,2,709,95.1,3.2,0.0,0.0,0.0,1.5
E07000090,HAVANT,57924,57711,98.8,85.9,85.9,1.2,1.2,0.0,0.0,0.1,0.8,0.4,99.3,0.0,57229,49769,49734,672,672,0,2,78,482,213,57523,0,7495,49734,0,2,76,404,12.9,85.9,0.0,0.0,0.1,0.7
E09000016,HAVERING,113792,112291,95.6,82.7,80.9,4.5,4.5,0.0,0.1,0.5,3.1,1.5,96.4,0.0,108760,94155,92025,5080,5080,46,153,533,3531,1653,109693,0,16735,92025,46,107,380,2998,14.7,80.9,0.0,0.1,0.3,2.6
E06000019,"HEREFORDSHIRE, COUNTY OF",90282,89974,87.1,24.7,20.2,17.1,17.1,1.1,3.0,5.5,12.5,2.1,95.1,3.7,78674,22311,18282,15465,15465,971,2688,4936,11300,1868,85902,3338,60392,18282,971,1717,2248,6364,66.9,20.2,1.1,1.9,2.5,7.0
E07000098,HERTSMERE,46324,46275,98.1,83.5,81.0,6.5,6.5,0.0,0.2,0.4,1.8,0.1,99.1,0.0,45461,38701,37533,3018,3018,5,92,168,814,56,45915,0,7928,37533,5,87,76,646,17.1,81.0,0.0,0.2,0.2,1.4
E07000037,HIGH PEAK,46014,45873,91.9,11.3,8.0,4.1,4.1,0.5,1.1,1.7,7.8,0.7,98.7,0.0,42299,5194,3696,1898,1898,221,500,805,3574,339,45433,0,38603,3696,221,279,305,2769,83.9,8.0,0.5,0.6,0.7,6.0
S12000017,HIGHLAND,115308,113153,81.1,8.3,8.3,8.3,8.3,2.2,4.3,7.5,17.0,3.8,93.6,4.4,93508,9531,9531,9531,9531,2528,4966,8679,19645,4366,107943,5072,83977,9531,2528,2438,3713,10966,72.8,8.3,2.2,2.1,3.2,9.5
E09000017,HILLINGDON,120682,119812,96.0,85.1,84.2,5.5,5.5,0.0,0.2,0.7,3.3,0.7,96.3,0.0,115873,102737,101599,6642,6642,46,284,904,3939,870,116170,0,14274,101599,46,238,620,3035,11.8,84.2,0.0,0.2,0.5,2.5
E07000132,HINCKLEY AND BOSWORTH,54791,54219,95.5,63.8,61.3,9.2,9.2,0.1,0.9,1.4,3.5,1.1,97.7,0.0,52305,34956,33564,5050,5052,49,491,742,1914,617,53529,0,18741,33564,49,442,251,1172,34.2,61.3,0.1,0.8,0.5,2.1
E07000227,HORSHAM,66945,66834,92.9,31.0,24.2,17.9,17.9,0.4,1.1,2.0,6.9,0.7,98.7,0.0,62208,20778,16209,11974,11974,239,728,1320,4626,477,66088,0,45999,16209,239,489,592,3306,68.7,24.2,0.4,0.7,0.9,4.9
E09000018,HOUNSLOW,100468,100142,97.6,85.7,85.6,11.4,11.4,0.0,0.1,0.3,2.1,0.3,97.7,0.0,98068,86111,85988,11422,11422,1,74,307,2074,342,98145,0,12080,85988,1,73,233,1767,12.0,85.6,0.0,0.1,0.2,1.8
E07000011,HUNTINGDONSHIRE,82934,82505,96.1,56.7,52.1,5.7,5.7,0.3,0.7,1.1,3.4,0.6,98.9,0.4,79666,47064,43235,4748,4748,234,549,935,2839,535,81981,316,36431,43235,234,315,386,1904,43.9,52.1,0.3,0.4,0.5,2.3
E07000120,HYNDBURN,41177,40925,97.9,70.5,64.8,7.4,7.5,0.0,0.1,0.2,1.5,0.6,99.2,49.8,40315,29045,26664,3036,3069,20,33,96,610,239,40858,20514,13651,26664,20,13,63,514,33.2,64.8,0.0,0.0,0.2,1.2
S12000018,INVERCLYDE,42012,41964,97.0,73.1,72.8,9.8,9.8,0.1,0.3,0.6,2.9,0.2,98.6,0.0,40746,30728,30583,4098,4098,41,122,256,1218,97,41408,0,10163,30583,41,81,134,962,24.2,72.8,0.1,0.2,0.3,2.3
E07000202,IPSWICH,65218,65103,98.5,87.5,84.3,4.1,4.1,0.0,0.1,0.3,1.3,0.2,98.8,0.0,64239,57095,55008,2645,2645,0,39,169,864,115,64407,0,9231,55008,0,39,130,695,14.2,84.3,0.0,0.1,0.2,1.1
W06000001,ISLE OF ANGLESEY,37150,36840,88.3,16.1,16.1,16.1,16.1,0.8,2.3,4.0,10.8,2.1,95.2,25.4,32810,5982,5981,5981,5981,312,844,1472,4030,765,35378,9441,26829,5981,312,532,628,2558,72.2,16.1,0.8,1.4,1.7,6.9
E06000046,ISLE OF WIGHT,78465,78192,93.8,26.8,26.8,26.8,26.8,0.3,0.7,1.3,5.9,0.6,99.4,0.0,73564,21055,21055,21055,21055,221,578,1007,4628,451,78000,0,52509,21055,221,357,429,3621,66.9,26.8,0.3,0.5,0.5,4.6
E06000053,ISLES OF SCILLY,1677,1666,94.2,0.0,0.0,0.0,0.0,0.0,0.0,0.2,5.1,0.7,99.3,0.0,1580,0,0,0,0,0,0,3,86,11,1666,0,1580,0,0,0,3,83,94.2,0.0,0.0,0.0,0.2,4.9
E09000019,ISLINGTON,118155,118076,95.3,80.9,79.9,16.1,16.1,0.0,0.0,0.0,4.7,0.1,95.3,0.0,112551,95536,94353,19022,19029,0,0,12,5525,78,112555,0,18198,94353,0,0,12,5513,15.4,79.9,0.0,0.0,0.0,4.7
E09000020,KENSINGTON AND CHELSEA,98852,98795,95.7,86.7,82.8,15.6,15.6,0.0,0.0,0.1,4.2,0.1,95.7,0.0,94638,85682,81888,15412,15412,0,0,51,4157,56,94639,0,12750,81888,0,0,51,4106,12.9,82.8,0.0,0.0,0.1,4.2
E07000153,KETTERING,48831,48416,97.4,77.8,72.6,12.0,12.0,0.0,0.4,0.7,1.7,1.1,98.0,0.1,47570,38011,35437,5845,5845,24,192,329,846,518,47860,34,12133,35437,24,168,137,517,24.8,72.6,0.0,0.3,0.3,1.1
E07000146,"KING'S LYNN AND WEST NORFOLK",78976,78493,91.2,10.8,6.5,3.4,3.4,0.4,1.1,2.3,8.2,1.2,98.0,3.0,71990,8553,5156,2673,2673,343,906,1798,6503,961,77388,2397,66834,5156,343,563,892,4705,84.6,6.5,0.4,0.7,1.1,6.0
E06000010,"KINGSTON UPON HULL, CITY OF",128548,126577,98.4,97.5,97.5,97.5,97.5,0.0,0.0,0.0,0.0,0.2,98.4,21.2,126548,125330,125330,125330,125330,0,0,8,29,213,126548,27205,1218,125330,0,0,8,21,0.9,97.5,0.0,0.0,0.0,0.0
E09000021,KINGSTON UPON THAMES,70723,70607,97.8,90.3,85.6,3.7,3.7,0.0,0.0,0.1,2.0,0.2,98.1,0.0,69181,63859,60550,2645,2645,0,4,84,1426,118,69352,0,8631,60550,0,4,80,1342,12.2,85.6,0.0,0.0,0.1,1.9
E08000034,KIRKLEES,196429,196273,97.1,68.0,67.8,22.1,22.4,0.0,0.2,0.5,2.9,0.1,99.1,0.0,190665,133537,133139,43410,43972,75,349,1066,5608,186,194594,0,57526,133139,75,274,717,4542,29.3,67.8,0.0,0.1,0.4,2.3
E08000011,KNOWSLEY,72874,72767,98.7,78.0,77.5,10.0,77.5,0.0,0.2,0.2,1.2,0.2,99.5,0.0,71903,56807,56492,7292,56480,15,111,179,864,119,72508,0,15411,56492,15,96,68,685,21.1,77.5,0.0,0.1,0.1,0.9
E09000022,LAMBETH,153753,153282,96.0,72.5,66.7,11.1,11.1,0.0,0.0,0.0,3.7,0.3,96.2,0.0,147662,111461,102523,17139,17139,0,0,3,5620,437,147917,0,45139,102523,0,0,3,5617,29.4,66.7,0.0,0.0,0.0,3.7
E07000121,LANCASTER,67830,67762,98.2,61.9,51.9,14.2,14.2,0.2,0.3,0.5,1.7,0.2,99.7,0.4,66593,41986,35232,9622,9622,142,210,357,1169,117,67628,303,31361,35232,142,68,147,812,46.2,51.9,0.2,0.1,0.2,1.2
E08000035,LEEDS,375153,374840,96.6,84.5,82.3,44.3,80.9,0.0,0.3,0.6,3.3,0.1,97.4,1.9,362426,317090,308892,166118,303572,170,992,2176,12414,489,365531,7221,53534,308892,170,822,1184,10238,14.3,82.3,0.0,0.2,0.3,2.7
E06000016,LEICESTER,145077,144931,99.0,90.8,89.0,7.5,7.5,0.0,0.0,0.2,0.9,0.1,99.2,0.0,143683,131663,129148,10884,10884,2,32,289,1248,147,143948,0,14535,129148,2,30,257,959,10.0,89.0,0.0,0.0,0.2,0.7
E07000063,LEWES,47446,47391,96.5,24.6,24.4,24.6,24.6,0.1,0.3,0.6,3.4,0.2,99.7,0.0,45764,11685,11594,11655,11655,57,140,272,1627,116,47294,0,34170,11594,57,83,132,1355,72.0,24.4,0.1,0.2,0.3,2.9
E09000023,LEWISHAM,138087,137610,95.2,65.1,62.0,14.0,14.0,0.0,0.0,0.2,4.4,0.3,95.5,0.0,131497,89906,85643,19346,19346,0,0,268,6113,470,131851,0,45854,85643,0,0,268,5845,33.2,62.0,0.0,0.0,0.2,4.2
E07000194,LICHFIELD,49301,49207,95.9,68.6,63.8,6.1,60.5,0.3,0.6,1.2,3.9,0.3,99.5,0.0,47266,33815,31465,2985,29834,145,290,597,1941,130,49042,0,15801,31465,145,145,307,1344,32.1,63.8,0.3,0.3,0.6,2.7
E07000138,LINCOLN,48243,48171,98.2,80.6,79.7,0.6,0.6,0.0,0.1,0.5,1.7,0.1,98.5,23.9,47371,38899,38447,296,296,14,30,242,800,59,47498,11545,8924,38447,14,16,212,558,18.5,79.7,0.0,0.0,0.4,1.2
N09000007,LISBURN AND CASTLEREAGH,60791,60331,92.7,72.6,72.4,56.3,56.3,0.4,1.4,2.3,6.5,1.3,98.5,0.0,56352,44110,44040,34217,34217,231,872,1411,3979,769,59851,0,12312,44040,231,641,539,2568,20.3,72.4,0.4,1.1,0.9,4.2
E08000012,LIVERPOOL,237969,236993,94.8,79.9,77.6,31.4,76.0,0.0,0.0,0.2,4.8,0.4,95.1,0.0,225490,190078,184622,74613,180770,3,36,470,11503,978,226274,0,40868,184622,3,33,434,11033,17.2,77.6,0.0,0.0,0.2,4.6
E06000032,LUTON,85829,85737,99.4,94.5,93.0,4.4,4.4,0.0,0.2,0.2,0.5,0.1,99.4,0.0,85292,81111,79829,3803,3803,7,151,189,445,88,85341,0,5463,79829,7,144,38,256,6.4,93.0,0.0,0.2,0.0,0.3
E07000110,MAIDSTONE,77671,77467,92.2,60.6,54.4,11.5,11.5,0.5,1.5,2.6,7.5,0.8,97.6,0.0,71609,47030,42286,8900,8900,380,1190,2013,5858,646,75811,0,29323,42286,380,810,823,3845,37.8,54.4,0.5,1.0,1.1,5.0
E07000074,MALDON,29966,29890,93.5,18.1,18.1,18.1,18.1,0.3,1.0,2.1,6.2,0.8,98.9,0.0,28033,5431,5431,5431,5431,96,306,622,1857,230,29639,0,22602,5431,96,210,316,1235,75.4,18.1,0.3,0.7,1.1,4.1
E07000235,MALVERN HILLS,38091,38023,89.4,23.1,16.1,11.5,11.5,0.6,2.4,4.4,10.4,1.0,97.5,6.2,34062,8801,6117,4397,4397,210,913,1682,3961,377,37155,2354,27945,6117,210,703,769,2279,73.4,16.1,0.6,1.8,2.0,6.0
E08000003,MANCHESTER,250619,250452,94.5,71.8,68.4,24.3,59.6,0.1,0.2,1.0,5.5,0.1,94.9,0.0,236793,180054,171430,60816,149391,157,428,2533,13659,167,237945,0,65363,171430,157,271,2105,11126,26.1,68.4,0.1,0.1,0.8,4.4
E07000174,MANSFIELD,52763,52727,98.9,88.5,85.9,9.0,9.0,0.0,0.1,0.2,1.1,0.1,99.6,0.0,52172,46715,45319,4754,4754,5,34,83,555,36,52556,0,6853,45319,5,29,49,472,13.0,85.9,0.0,0.1,0.1,0.9
E06000035,MEDWAY,121321,121194,97.3,82.3,78.6,4.4,4.4,0.0,0.3,0.7,2.5,0.2,98.8,0.0,118102,99818,95358,5305,5305,31,326,869,3092,183,119831,0,22744,95358,31,295,543,2223,18.7,78.6,0.0,0.2,0.4,1.8
E07000133,MELTON,24666,24581,93.4,46.5,46.0,2.0,2.0,0.8,2.0,3.1,6.2,1.1,97.0,2.4,23048,11463,11354,482,482,195,500,766,1533,272,23936,582,11694,11354,195,305,266,767,47.4,46.0,0.8,1.2,1.1,3.1
E07000187,MENDIP,55684,55529,84.0,33.4,27.1,4.8,4.8,0.7,2.6,5.9,15.8,1.5,94.0,0.2,46750,18613,15073,2684,2684,386,1428,3278,8779,853,52356,115,31677,15073,386,1042,1850,5501,56.9,27.1,0.7,1.9,3.3,9.9
W06000024,MERTHYR TYDFIL,28441,28402,96.9,10.0,10.0,10.0,10.0,0.2,0.3,0.5,3.0,0.2,99.6,10.1,27555,2845,2845,2845,2845,45,80,131,847,47,28334,2885,24710,2845,45,35,51,716,86.9,10.0,0.2,0.1,0.2,2.5
E09000024,MERTON,89607,89570,98.4,87.9,87.1,29.1,29.1,0.0,0.0,0.2,1.6,0.0,98.4,0.0,88139,78734,78007,26077,26077,1,36,181,1431,35,88168,0,10132,78007,1,35,145,1250,11.3,87.1,0.0,0.0,0.2,1.4
N09000008,MID AND EAST ANTRIM,61569,60956,89.4,58.2,57.9,58.2,58.2,2.1,3.5,4.8,9.6,2.1,97.8,0.0,55029,35841,35633,35840,35840,1273,2148,2950,5927,1263,60241,0,19396,35633,1273,875,802,2977,31.5,57.9,2.1,1.4,1.3,4.8
E07000042,MID DEVON,37362,37157,79.0,4.6,4.6,4.6,4.6,1.8,5.8,10.6,20.4,2.9,92.9,11.6,29532,1729,1729,1727,1727,691,2158,3960,7625,1102,34698,4346,27803,1729,691,1467,1802,3665,74.4,4.6,1.8,3.9,4.8,9.8
E07000203,MID SUFFOLK,48147,47950,91.7,14.5,13.3,12.7,12.7,0.5,1.0,2.1,7.9,1.1,98.3,0.0,44142,6964,6382,6098,6098,228,497,1003,3808,553,47334,0,37760,6382,228,269,506,2805,78.4,13.3,0.5,0.6,1.1,5.8
E07000228,MID SUSSEX,69326,68545,94.3,29.0,25.7,23.0,23.0,0.0,0.3,0.8,4.6,1.4,98.5,0.0,65383,20103,17811,15960,15960,32,184,538,3162,939,68252,0,47572,17811,32,152,354,2624,68.6,25.7,0.0,0.2,0.5,3.8
N09000009,MID ULSTER,55420,54659,77.4,31.7,31.7,31.7,31.7,3.7,6.9,10.4,21.2,5.2,97.5,4.5,42892,17559,17558,17558,17558,2072,3820,5741,11767,2873,54056,2491,25334,17558,2072,1748,1921,6026,45.7,31.7,3.7,3.2,3.5,10.9
E06000002,MIDDLESBROUGH,67660,67643,96.9,90.6,90.2,2.2,2.2,0.1,0.5,1.0,3.1,0.0,97.2,0.3,65546,61300,61040,1499,1499,67,322,657,2097,20,65743,171,4506,61040,67,255,335,1440,6.7,90.2,0.1,0.4,0.5,2.1
S12000019,MIDLOTHIAN,40548,40324,93.4,38.3,38.0,38.3,38.3,0.7,1.6,2.7,6.0,0.8,98.0,5.2,37883,15520,15402,15518,15519,267,631,1075,2441,342,39722,2121,22481,15402,267,364,444,1366,55.4,38.0,0.7,0.9,1.1,3.4
E06000042,MILTON KEYNES,121449,121243,97.9,86.3,84.7,83.3,83.3,0.1,0.4,1.0,1.9,0.2,98.6,0.0,118915,104812,102922,101173,101173,86,488,1227,2328,298,119797,0,15993,102922,86,402,739,1101,13.2,84.7,0.1,0.3,0.6,0.9
E07000210,MOLE VALLEY,39896,39834,95.4,60.7,60.7,10.3,10.3,0.1,0.3,0.8,4.4,0.4,99.3,0.0,38077,24223,24207,4092,4092,21,108,323,1757,175,39597,0,13870,24207,21,87,215,1434,34.8,60.7,0.1,0.2,0.5,3.6
W06000021,MONMOUTHSHIRE,45098,44891,86.6,24.3,15.2,8.7,8.7,1.5,3.4,6.1,13.0,2.6,95.9,0.2,39049,10957,6855,3930,3930,654,1518,2758,5842,1164,43267,79,32194,6855,654,864,1240,3084,71.4,15.2,1.5,1.9,2.7,6.8
S12000020,MORAY,49316,48924,84.3,9.5,9.5,9.5,9.5,1.6,4.5,7.0,14.9,3.4,95.4,0.0,41572,4697,4697,4697,4697,797,2198,3457,7352,1655,47049,0,36875,4697,797,1401,1259,3895,74.8,9.5,1.6,2.8,2.6,7.9
S12000013,NA H-EILEANAN SIAR,16592,15186,75.3,3.7,3.7,3.7,3.7,2.8,4.2,5.5,16.3,10.8,88.3,0.0,12487,620,620,620,620,460,696,912,2699,1789,14645,0,11867,620,460,236,216,1787,71.5,3.7,2.8,1.4,1.3,10.8
W06000012,NEATH PORT TALBOT,68897,68849,96.9,58.1,58.1,3.0,3.0,0.1,0.2,0.4,3.1,0.2,99.3,35.5,66744,40033,40022,2038,2038,55,141,267,2105,114,68401,24439,26722,40022,55,86,126,1838,38.8,58.1,0.1,0.1,0.2,2.7
E07000091,NEW FOREST,87250,87041,93.0,26.5,20.3,10.2,10.3,0.5,0.8,1.5,6.8,0.9,98.9,0.0,81121,23127,17670,8932,8961,430,736,1344,5920,788,86255,0,63451,17670,430,306,608,4576,72.7,20.3,0.5,0.4,0.7,5.2
E07000175,NEWARK AND SHERWOOD,59178,58919,95.7,54.4,54.1,14.1,14.1,0.3,0.9,1.3,3.8,0.6,98.7,0.0,56658,32166,31988,8370,8371,158,508,762,2261,366,58392,8,24670,31988,158,350,254,1499,41.7,54.1,0.3,0.6,0.4,2.5
E08000021,NEWCASTLE UPON TYNE,146048,145652,95.4,70.5,65.1,18.9,18.9,0.0,0.1,0.2,4.3,0.3,96.2,0.0,139334,102987,95047,27599,27616,16,79,259,6318,396,140445,0,44287,95047,16,63,180,6059,30.3,65.1,0.0,0.0,0.1,4.1
E07000195,NEWCASTLE-UNDER-LYME,61074,60555,95.9,66.2,64.2,11.6,11.6,0.0,0.3,0.7,3.2,1.0,98.5,2.2,58578,40453,39212,7058,7058,21,156,411,1977,584,60143,1341,19366,39212,21,135,255,1566,31.7,64.2,0.0,0.2,0.4,2.6
E09000025,NEWHAM,126690,126415,97.7,85.9,80.7,18.4,18.4,0.0,0.1,0.6,2.0,0.2,97.8,0.0,123823,108833,102267,23285,23285,3,82,704,2592,280,123845,0,21556,102267,3,79,622,1888,17.0,80.7,0.0,0.1,0.5,1.5
W06000022,NEWPORT,72161,72087,97.3,72.7,69.6,7.5,7.5,0.1,0.3,0.8,2.6,0.2,98.2,34.2,70202,52435,50232,5392,5392,68,229,563,1885,143,70827,24714,19970,50232,68,161,334,1322,27.7,69.6,0.1,0.2,0.5,1.8
N09000010,"NEWRY, MOURNE AND DOWN",70669,69239,82.6,33.4,33.4,33.4,33.4,2.9,5.3,7.5,15.4,4.2,97.3,3.3,58378,23593,23593,23593,23593,2035,3770,5335,10861,2980,68731,2306,34785,23593,2035,1735,1565,5526,49.2,33.4,2.9,2.5,2.2,7.8
S12000021,NORTH AYRSHIRE,71985,71902,94.1,29.6,29.6,9.4,9.4,0.4,0.9,1.8,5.8,0.4,98.9,0.0,67717,21327,21319,6774,6774,320,639,1280,4185,296,71225,0,46398,21319,320,319,641,2905,64.5,29.6,0.4,0.4,0.9,4.0
E07000043,NORTH DEVON,51268,51052,86.3,4.7,4.7,4.7,4.7,1.5,3.5,6.7,13.2,1.7,93.9,53.4,44261,2395,2395,2395,2395,772,1788,3418,6791,889,48126,27370,41866,2395,772,1016,1630,3373,81.7,4.7,1.5,2.0,3.2,6.6
E07000038,NORTH EAST DERBYSHIRE,48466,48393,93.0,25.0,23.4,21.4,21.4,0.3,0.9,1.4,6.8,0.3,99.2,0.0,45081,12110,11352,10395,10395,157,413,673,3312,138,48087,0,33729,11352,157,256,260,2639,69.6,23.4,0.3,0.5,0.5,5.4
E06000012,NORTH EAST LINCOLNSHIRE,74119,74013,96.9,88.2,87.8,0.7,0.7,0.1,0.8,1.3,3.0,0.4,97.7,25.8,71810,65396,65057,498,498,71,620,931,2203,260,72404,19132,6753,65057,71,549,311,1272,9.1,87.8,0.1,0.7,0.4,1.7
E07000099,NORTH HERTFORDSHIRE,60871,60783,95.9,65.5,64.0,2.5,2.5,0.1,0.4,1.0,4.0,0.4,98.4,0.0,58346,39841,38939,1494,1494,50,216,598,2437,220,59868,0,19407,38939,50,166,382,1839,31.9,64.0,0.1,0.3,0.6,3.0
E07000139,NORTH KESTEVEN,54630,54504,93.5,35.9,34.4,3.8,3.8,0.7,1.4,2.2,6.2,0.7,98.0,4.9,51099,19592,18788,2072,2072,378,765,1176,3405,367,53535,2655,32311,18788,378,387,411,2229,59.1,34.4,0.7,0.7,0.8,4.1
S12000050,NORTH LANARKSHIRE,164951,164807,97.8,76.2,75.1,9.7,74.9,0.1,0.3,0.6,2.1,0.2,99.0,0.0,161276,125752,123844,16060,123519,92,521,1039,3531,309,163362,0,37432,123844,92,429,518,2492,22.7,75.1,0.1,0.3,0.3,1.5
E06000013,NORTH LINCOLNSHIRE,80552,80322,94.0,45.1,45.1,5.8,5.8,0.6,1.2,1.8,5.7,0.5,97.7,52.0,75740,36325,36302,4700,4700,463,936,1472,4582,392,78722,41850,39438,36302,463,473,536,3110,49.0,45.1,0.6,0.6,0.7,3.9
E07000147,NORTH NORFOLK,60461,60281,90.6,4.2,4.2,4.2,4.2,0.5,1.6,2.9,9.1,2.0,97.6,0.1,54807,2538,2538,2532,2532,320,978,1730,5474,1212,59009,61,52269,2538,320,658,752,3744,86.5,4.2,0.5,1.1,1.2,6.2
E06000024,NORTH SOMERSET,103657,102562,90.9,47.2,40.1,16.7,16.7,0.3,0.9,2.0,8.1,1.2,95.6,0.0,94195,48940,41565,17270,17270,314,889,2078,8367,1259,99110,0,52630,41565,314,575,1189,6289,50.8,40.1,0.3,0.6,1.1,6.1
E08000022,NORTH TYNESIDE,102301,102092,98.1,66.4,63.6,3.9,3.9,0.0,0.1,0.5,1.7,0.3,99.1,0.0,100385,67970,65019,3949,3949,23,151,481,1707,257,101380,0,35366,65019,23,128,330,1226,34.6,63.6,0.0,0.1,0.3,1.2
E07000218,NORTH WARWICKSHIRE,30287,30226,95.9,27.0,25.1,10.6,23.6,0.3,1.0,1.5,3.9,0.3,99.3,0.0,29041,8178,7607,3197,7162,98,297,447,1185,87,30084,0,21434,7607,98,199,150,738,70.8,25.1,0.3,0.7,0.5,2.4
E07000134,NORTH WEST LEICESTERSHIRE,48334,48257,95.7,67.5,65.8,4.3,4.3,0.2,0.8,1.4,4.1,0.5,99.0,0.0,46271,32604,31803,2075,2075,73,403,687,1986,220,47833,0,14468,31803,73,330,284,1299,29.9,65.8,0.2,0.7,0.6,2.7
E07000154,NORTHAMPTON,106107,103913,97.2,85.8,83.8,13.9,13.9,0.0,0.0,0.1,0.8,2.1,97.3,1.2,103085,91008,88967,14744,14745,6,45,154,828,2200,103294,1262,14118,88967,6,39,109,674,13.3,83.8,0.0,0.0,0.1,0.6
E06000057,NORTHUMBERLAND,156451,156122,92.9,14.6,9.2,5.7,5.7,0.9,1.7,2.4,6.9,0.8,98.7,5.4,145293,22816,14416,8991,8991,1330,2624,3785,10829,1283,154467,8499,130877,14416,1330,1294,1161,7044,83.7,9.2,0.9,0.8,0.7,4.5
E07000148,NORWICH,58301,58202,98.5,85.0,82.2,0.2,0.2,0.0,0.0,0.4,1.3,0.2,98.8,0.0,57428,49561,47899,138,138,0,7,259,774,99,57585,0,9529,47899,0,7,252,515,16.3,82.2,0.0,0.0,0.4,0.9
E06000018,NOTTINGHAM,145818,145736,97.9,91.8,90.2,21.0,21.0,0.0,0.0,0.2,2.0,0.1,98.1,0.0,142826,133896,131507,30693,30693,4,68,349,2910,80,143052,0,11319,131507,4,64,281,2561,7.8,90.2,0.0,0.0,0.2,1.8
E07000219,NUNEATON AND BEDWORTH,60343,60307,98.9,78.4,78.4,6.5,78.4,0.0,0.1,0.2,1.0,0.1,99.6,0.0,59693,47329,47312,3918,47312,12,79,122,614,42,60101,0,12381,47312,12,67,43,492,20.5,78.4,0.0,0.1,0.1,0.8
E07000135,OADBY AND WIGSTON,25531,25477,98.7,78.6,76.0,3.0,3.0,0.0,0.0,0.1,1.1,0.2,99.1,0.0,25195,20064,19416,759,759,0,4,22,282,53,25306,0,5779,19416,0,4,18,260,22.6,76.0,0.0,0.0,0.1,1.0
E08000004,OLDHAM,98555,98364,98.2,76.6,76.3,14.2,14.4,0.1,0.2,0.3,1.7,0.2,99.5,0.0,96735,75496,75189,13960,14156,74,160,328,1629,189,98103,0,21546,75189,74,86,168,1301,21.9,76.3,0.1,0.1,0.2,1.3
S12000023,ORKNEY ISLANDS,12765,12218,64.2,1.1,1.1,1.1,1.1,4.1,9.6,20.7,31.5,7.3,76.5,0.0,8200,135,135,135,135,519,1221,2640,4018,936,9761,0,8065,135,519,702,1419,1378,63.2,1.1,4.1,5.5,11.1,10.8
E07000178,OXFORD,66679,66538,97.7,85.4,81.0,2.5,2.5,0.0,0.0,0.3,2.1,0.2,97.8,0.0,65134,56948,53998,1691,1691,0,31,208,1404,142,65230,0,11136,53998,0,31,177,1196,16.7,81.0,0.0,0.0,0.3,1.8
W06000009,PEMBROKESHIRE,65716,65580,87.8,6.4,6.4,6.4,6.4,1.8,3.9,6.6,12.0,2.1,95.1,5.1,57670,4181,4181,4176,4176,1156,2583,4315,7910,1398,62488,3361,53489,4181,1156,1427,1732,3595,81.4,6.4,1.8,2.2,2.6,5.5
E07000122,PENDLE,43756,43606,96.1,52.7,52.3,1.4,51.9,0.4,0.9,1.3,3.6,0.5,98.7,4.1,42032,23038,22881,625,22691,169,393,553,1574,216,43209,1815,19151,22881,169,224,160,1021,43.8,52.3,0.4,0.5,0.4,2.3
S12000048,PERTH AND KINROSS,78555,78053,85.2,35.1,34.1,4.6,4.6,1.6,4.1,7.2,14.1,2.4,95.2,0.0,66955,27551,26814,3615,3615,1296,3258,5645,11098,1877,74800,0,40141,26814,1296,1962,2387,5453,51.1,34.1,1.6,2.5,3.0,6.9
E06000031,PETERBOROUGH,91867,91753,97.7,80.5,79.7,47.1,47.1,0.1,0.3,0.5,2.1,0.2,98.8,0.0,89795,73928,73253,43293,43293,63,254,418,1958,164,90724,0,16542,73253,63,191,164,1540,18.0,79.7,0.1,0.2,0.2,1.7
E06000026,PLYMOUTH,125825,125389,96.6,87.7,85.9,2.8,2.8,0.0,0.1,0.8,3.1,0.4,97.0,26.6,121496,110411,108066,3461,3461,3,182,1024,3893,443,122044,33440,13430,108066,3,179,842,2869,10.7,85.9,0.0,0.1,0.7,2.3
E06000044,PORTSMOUTH,95667,95502,97.6,93.8,91.8,7.1,7.1,0.0,0.1,0.4,2.2,0.2,97.7,0.0,93367,89723,87840,6745,6745,1,108,408,2135,166,93457,0,5527,87840,1,107,300,1727,5.8,91.8,0.0,0.1,0.3,1.8
W06000023,POWYS,69258,68203,77.5,16.3,16.3,16.3,16.3,3.4,7.3,12.3,21.0,5.7,88.2,7.1,53658,11317,11316,11314,11314,2373,5063,8488,14545,3958,61088,4919,42342,11316,2373,2690,3425,6057,61.1,16.3,3.4,3.9,4.9,8.7
E07000123,PRESTON,67291,67093,97.4,71.3,69.0,5.7,5.7,0.0,0.1,0.5,2.3,0.4,98.7,34.9,65524,47969,46456,3856,3856,28,57,316,1569,285,66394,23474,19068,46456,28,29,259,1253,28.3,69.0,0.0,0.0,0.4,1.9
E06000038,READING,75072,74952,98.6,89.5,86.1,10.0,82.9,0.0,0.0,0.1,1.2,0.2,98.8,0.0,74021,67160,64632,7484,62228,3,26,64,931,120,74190,0,9389,64632,3,23,38,867,12.5,86.1,0.0,0.0,0.1,1.2
E09000026,REDBRIDGE,110968,110715,97.1,83.2,82.4,27.3,27.3,0.0,0.1,0.3,2.6,0.2,97.6,0.0,107791,92380,91462,30293,30293,2,66,343,2924,243,108339,0,16329,91462,2,64,277,2581,14.7,82.4,0.0,0.1,0.2,2.3
E06000003,REDCAR AND CLEVELAND,67990,67951,96.6,86.1,85.1,1.1,1.1,0.1,0.6,1.4,3.3,0.2,97.9,0.3,65689,58572,57836,719,719,88,377,919,2262,149,66591,236,7853,57836,88,289,542,1343,11.6,85.1,0.1,0.4,0.8,2.0
E07000236,REDDITCH,39435,39356,98.0,78.2,78.1,2.0,78.2,0.0,0.0,0.1,1.8,0.2,99.0,0.1,38639,30839,30813,788,30819,2,13,40,717,81,39028,31,7826,30813,2,11,27,677,19.8,78.1,0.0,0.0,0.1,1.7
E07000211,REIGATE AND BANSTEAD,64045,63994,97.6,74.6,73.8,19.7,19.7,0.0,0.1,0.2,2.4,0.1,99.7,0.0,62487,47799,47283,12606,12606,11,75,145,1507,85,63855,0,15204,47283,11,64,70,1362,23.7,73.8,0.0,0.1,0.1,2.1
S12000038,RENFREWSHIRE,94677,94625,96.6,73.7,73.6,11.3,44.3,0.1,0.3,0.6,3.3,0.1,98.3,0.0,91475,69789,69707,10671,41918,105,268,563,3150,86,93110,0,21768,69707,105,163,295,2587,23.0,73.6,0.1,0.2,0.3,2.7
W06000016,RHONDDA CYNON TAF,118764,118366,97.3,21.0,16.7,6.6,6.6,0.0,0.1,0.5,2.3,0.5,99.1,27.0,115616,24944,19825,7853,7853,57,109,537,2750,578,117646,32036,95791,19825,57,52,428,2213,80.7,16.7,0.0,0.0,0.4,1.9
E07000124,RIBBLE VALLEY,30149,30089,90.7,22.8,22.5,21.4,21.7,0.8,2.2,3.8,9.1,0.8,98.6,51.6,27332,6864,6784,6438,6536,228,650,1158,2757,233,29730,15553,20548,6784,228,422,508,1599,68.2,22.5,0.8,1.4,1.7,5.3
E09000027,RICHMOND UPON THAMES,88735,88609,98.3,87.2,85.0,15.7,15.7,0.0,0.0,0.2,1.6,0.1,98.5,0.0,87232,77344,75409,13917,13917,0,17,192,1377,127,87364,0,11823,75409,0,17,175,1185,13.3,85.0,0.0,0.0,0.2,1.3
E07000166,RICHMONDSHIRE,25309,25155,84.0,23.7,12.7,4.9,4.9,2.4,4.7,8.0,15.4,3.0,96.2,34.2,21257,5991,3216,1231,1231,611,1199,2021,3898,770,24349,8648,18041,3216,611,588,822,1877,71.3,12.7,2.4,2.3,3.2,7.4
E08000005,ROCHDALE,100978,100815,97.7,71.3,64.6,10.4,10.4,0.0,0.1,0.4,2.1,0.2,99.3,0.0,98647,71967,65229,10470,10478,23,97,374,2168,189,100240,0,33418,65229,23,74,277,1794,33.1,64.6,0.0,0.1,0.3,1.8
E07000075,ROCHFORD,37791,37657,97.0,16.8,11.9,7.6,7.6,0.0,0.1,0.5,2.6,0.3,99.2,0.0,36657,6345,4484,2875,2875,2,56,182,1000,118,37474,0,32173,4484,2,54,126,818,85.1,11.9,0.0,0.1,0.3,2.2
E07000125,ROSSENDALE,34890,34707,94.2,53.2,43.6,1.4,1.4,0.1,0.7,1.0,5.3,0.7,98.7,0.0,32873,18573,15224,476,476,30,249,345,1834,237,34437,12,17649,15224,30,219,96,1489,50.6,43.6,0.1,0.6,0.3,4.3
E07000064,ROTHER,49332,49153,93.1,4.8,4.8,4.8,4.8,0.1,0.4,1.3,6.5,0.6,99.3,0.0,45947,2359,2359,2359,2359,55,195,646,3206,279,48981,0,43588,2359,55,140,451,2560,88.4,4.8,0.1,0.3,0.9,5.2
E08000018,ROTHERHAM,124292,124155,98.2,61.6,59.3,9.3,9.3,0.0,0.2,0.4,1.7,0.1,99.4,0.4,122004,76613,73724,11555,11557,30,218,528,2151,185,123520,525,48280,73724,30,188,310,1623,38.8,59.3,0.0,0.2,0.2,1.3
E07000220,RUGBY,50256,50143,96.8,67.0,63.5,14.5,60.0,0.3,0.6,0.9,3.0,0.3,98.8,0.0,48650,33670,31897,7285,30174,160,282,461,1493,168,49651,0,16753,31897,160,122,179,1032,33.3,63.5,0.3,0.2,0.4,2.1
E07000212,RUNNYMEDE,38496,38438,96.3,70.6,68.1,3.1,3.1,0.0,0.0,0.7,3.6,0.2,98.1,0.0,37054,27189,26202,1176,1176,0,19,255,1384,69,37761,0,10852,26202,0,19,236,1129,28.2,68.1,0.0,0.0,0.6,2.9
E07000176,RUSHCLIFFE,53938,53863,97.1,75.0,71.7,20.1,20.1,0.2,0.4,0.8,2.7,0.3,99.4,0.5,52396,40463,38650,10818,10818,95,221,457,1467,136,53610,269,13746,38650,95,126,236,1010,25.5,71.7,0.2,0.2,0.4,1.9
E07000092,RUSHMOOR,42861,42822,97.4,81.4,81.1,4.2,4.2,0.1,0.9,1.5,2.5,0.2,97.6,0.0,41742,34889,34775,1817,1817,50,391,646,1080,74,41817,0,6967,34775,50,341,255,434,16.3,81.1,0.1,0.8,0.6,1.0
E06000017,RUTLAND,18588,18547,91.6,12.1,12.1,12.1,12.1,0.3,0.5,0.8,8.2,0.3,99.3,0.0,17029,2248,2248,2248,2248,49,86,144,1518,65,18454,0,14781,2248,49,37,58,1374,79.5,12.1,0.3,0.2,0.3,7.4
E07000167,RYEDALE,29986,29591,83.4,7.4,7.4,7.4,7.4,3.0,5.6,8.4,15.3,3.3,94.2,17.7,24996,2211,2211,2211,2211,902,1694,2526,4595,975,28253,5319,22785,2211,902,792,832,2069,76.0,7.4,3.0,2.6,2.8,6.9
E08000006,SALFORD,128861,128710,95.9,82.6,82.1,56.5,81.7,0.0,0.7,1.8,4.0,0.1,96.1,0.0,123551,106382,105822,72831,105280,14,852,2376,5159,155,123781,0,17729,105822,14,838,1524,2783,13.8,82.1,0.0,0.7,1.2,2.2
E08000028,SANDWELL,141885,141759,99.3,81.6,80.0,11.2,70.1,0.0,0.0,0.2,0.6,0.1,99.4,0.0,140873,115809,113471,15876,99429,4,21,342,886,124,141018,1,27402,113471,4,17,321,544,19.3,80.0,0.0,0.0,0.2,0.4
E07000168,SCARBOROUGH,63337,63241,93.3,2.6,2.6,2.6,2.6,0.6,1.3,1.9,6.5,0.7,97.9,1.8,59121,1655,1655,1652,1652,380,804,1210,4120,419,61979,1111,57466,1655,380,424,406,2910,90.7,2.6,0.6,0.7,0.6,4.6
S12000026,SCOTTISH BORDERS,61777,61162,85.8,14.2,11.2,9.1,9.1,1.6,4.1,7.1,13.2,3.2,95.2,14.5,52977,8784,6947,5649,5649,1019,2520,4398,8185,1991,58817,8971,46030,6947,1019,1501,1878,3787,74.5,11.2,1.6,2.4,3.0,6.1
E07000188,SEDGEMOOR,59326,59228,91.1,25.8,13.6,6.2,6.2,0.5,1.6,2.9,8.8,0.9,96.7,0.0,54027,15309,8089,3651,3651,278,938,1737,5201,546,57376,0,45938,8089,278,660,799,3464,77.4,13.6,0.5,1.1,1.3,5.8
E08000014,SEFTON,135290,135011,98.4,71.0,65.6,26.4,60.5,0.0,0.1,0.2,1.4,0.2,99.5,0.0,133102,96104,88726,35690,81824,51,147,259,1909,289,134628,0,44376,88726,51,96,112,1650,32.8,65.6,0.0,0.1,0.1,1.2
E07000169,SELBY,42857,42656,91.2,19.0,19.0,19.0,19.0,0.8,1.5,2.5,8.3,0.8,97.8,14.0,39102,8137,8136,8134,8135,353,654,1060,3554,364,41904,6013,30966,8136,353,301,406,2494,72.3,19.0,0.8,0.7,0.9,5.8
E07000111,SEVENOAKS,53314,53249,92.3,39.7,39.3,15.3,15.3,0.2,0.6,1.2,7.6,0.4,99.5,0.0,49222,21157,20976,8148,8148,107,300,655,4027,199,53021,0,28246,20976,107,193,355,3372,53.0,39.3,0.2,0.4,0.7,6.3
E08000019,SHEFFIELD,262324,261853,96.2,50.1,46.5,4.5,4.5,0.0,0.1,0.5,3.6,0.2,97.4,0.1,252353,131530,121955,11914,11915,55,238,1226,9500,522,255440,287,130398,121955,55,183,988,8274,49.7,46.5,0.0,0.1,0.4,3.2
S12000027,SHETLAND ISLANDS,11302,10955,70.1,1.9,1.9,1.9,1.9,3.1,7.1,16.7,26.9,6.3,83.8,0.0,7919,211,211,211,211,345,807,1889,3036,709,9475,0,7708,211,345,462,1082,1147,68.2,1.9,3.1,4.1,9.6,10.1
E06000051,SHROPSHIRE,152765,152185,86.6,20.1,14.0,6.5,6.5,0.9,3.0,5.7,13.0,0.9,96.0,78.2,132356,30716,21320,9922,9922,1416,4545,8771,19829,1418,146655,119441,111036,21320,1416,3129,4226,11058,72.7,14.0,0.9,2.0,2.8,7.2
E06000039,SLOUGH,57620,57504,98.7,90.1,86.2,15.7,15.7,0.0,0.1,0.2,1.1,0.2,99.0,0.0,56894,51932,49687,9048,9048,10,48,136,610,112,57026,0,7207,49687,10,38,88,474,12.5,86.2,0.0,0.1,0.2,0.8
E08000029,SOLIHULL,96933,96815,97.4,85.8,84.9,22.2,84.1,0.0,0.2,0.9,2.4,0.1,98.3,0.0,94450,83163,82278,21513,81495,18,149,856,2365,127,95251,1,12172,82278,18,131,707,1509,12.6,84.9,0.0,0.1,0.7,1.6
E07000246,SOMERSET WEST AND TAUNTON,77498,77252,88.5,23.1,13.3,5.4,5.4,0.9,2.6,5.0,11.2,1.6,95.9,5.5,68555,17864,10314,4178,4178,677,2051,3904,8697,1208,74333,4287,58241,10314,677,1374,1853,4793,75.2,13.3,0.9,1.8,2.4,6.2
S12000028,SOUTH AYRSHIRE,58823,58736,93.7,57.5,56.3,1.0,1.0,0.4,1.3,2.7,6.2,1.0,98.4,0.0,55107,33846,33095,599,599,222,752,1584,3629,564,57877,0,22012,33095,222,530,832,2045,37.4,56.3,0.4,0.9,1.4,3.5
E07000012,SOUTH CAMBRIDGESHIRE,71105,70947,95.3,55.9,53.9,15.4,15.4,0.2,0.5,1.5,4.5,0.4,98.4,0.8,67766,39742,38298,10936,10936,143,368,1045,3181,262,69970,549,29468,38298,143,225,677,2136,41.4,53.9,0.2,0.3,1.0,3.0
E07000039,SOUTH DERBYSHIRE,48496,48291,94.0,32.3,27.0,16.9,16.9,0.2,1.1,1.5,5.6,0.7,98.7,0.0,45583,15677,13101,8193,8193,113,530,749,2708,339,47845,0,32482,13101,113,417,219,1959,67.0,27.0,0.2,0.9,0.5,4.0
E06000025,SOUTH GLOUCESTERSHIRE,125878,125685,98.1,79.0,77.9,11.6,11.7,0.1,0.2,0.6,1.7,0.2,99.3,0.0,123525,99426,98054,14636,14685,118,259,754,2160,289,125054,0,25471,98054,118,141,495,1406,20.2,77.9,0.1,0.1,0.4,1.1
E07000044,SOUTH HAMS,48337,48153,81.7,22.1,21.3,17.7,17.7,0.8,2.8,7.2,18.0,2.3,94.2,32.1,39475,10698,10300,8569,8569,380,1370,3495,8678,1107,45534,15538,29175,10300,380,990,2125,5183,60.4,21.3,0.8,2.0,4.4,10.7
E07000140,SOUTH HOLLAND,43878,43723,88.2,11.8,8.5,6.4,6.4,0.4,1.7,3.3,11.4,1.3,98.7,0.5,38706,5193,3739,2789,2789,196,756,1455,5017,555,43315,231,34967,3739,196,560,699,3562,79.7,8.5,0.4,1.3,1.6,8.1
E07000141,SOUTH KESTEVEN,68495,68400,93.5,33.0,30.9,4.3,4.3,0.7,1.2,1.9,6.3,0.4,98.8,0.0,64074,22631,21140,2918,2918,503,849,1286,4326,268,67670,0,42934,21140,503,346,437,3040,62.7,30.9,0.7,0.5,0.6,4.4
E07000031,SOUTH LAKELAND,60263,60139,92.9,13.0,11.5,10.4,10.4,0.4,1.0,2.0,6.9,1.0,98.5,38.6,55972,7861,6930,6260,6260,251,629,1204,4167,619,59338,23291,49042,6930,251,378,575,2963,81.4,11.5,0.4,0.6,1.0,4.9
S12000029,SOUTH LANARKSHIRE,160677,159968,95.1,65.7,65.2,10.9,64.8,0.4,1.1,2.1,4.5,0.8,98.2,0.0,152724,105566,104770,17454,104197,694,1738,3399,7244,1238,157811,0,47954,104770,694,1044,1661,3845,29.8,65.2,0.4,0.6,1.0,2.4
E07000149,SOUTH NORFOLK,65648,65516,90.6,14.1,13.1,8.4,8.4,0.4,1.4,2.7,9.2,1.4,98.3,0.0,59493,9257,8582,5483,5483,247,926,1790,6023,908,64520,0,50911,8582,247,679,864,4233,77.6,13.1,0.4,1.0,1.3,6.4
E07000155,SOUTH NORTHAMPTONSHIRE,42882,42749,92.6,32.9,25.3,20.3,20.3,0.2,2.0,3.1,7.1,0.9,96.3,0.7,39724,14128,10843,8716,8716,88,875,1310,3025,370,41311,284,28881,10843,88,787,435,1715,67.3,25.3,0.2,1.8,1.0,4.0
E07000179,SOUTH OXFORDSHIRE,66617,66325,95.9,51.3,46.2,23.6,23.6,0.1,0.3,0.7,3.7,0.6,99.3,0.0,63874,34146,30790,15712,15713,80,233,444,2451,385,66164,0,33084,30790,80,153,211,2007,49.7,46.2,0.1,0.2,0.3,3.0
E07000126,SOUTH RIBBLE,52966,52886,96.5,67.5,66.0,5.0,5.0,0.1,0.4,0.8,3.3,0.2,99.0,6.9,51122,35755,34960,2643,2643,27,193,430,1764,86,52451,3670,16162,34960,27,166,237,1334,30.5,66.0,0.1,0.3,0.4,2.5
E07000189,SOUTH SOMERSET,84395,83751,88.0,3.4,3.1,3.0,3.0,0.5,2.4,4.3,11.2,1.5,96.6,4.2,74291,2909,2650,2561,2561,430,2053,3663,9460,1297,81517,3578,71641,2650,430,1623,1610,5797,84.9,3.1,0.5,1.9,1.9,6.9
E07000196,SOUTH STAFFORDSHIRE,49794,49723,92.4,35.6,31.2,28.2,28.3,0.2,0.9,1.9,7.5,0.2,98.5,5.4,46005,17747,15523,14031,14103,109,430,970,3718,102,49069,2708,30482,15523,109,321,540,2748,61.2,31.2,0.2,0.6,1.1,5.5
E08000023,SOUTH TYNESIDE,75522,75498,97.7,76.6,76.0,1.0,1.0,0.1,0.3,0.5,2.3,0.0,98.8,0.0,73769,57830,57398,766,766,49,222,410,1729,24,74628,0,16371,57398,49,173,188,1319,21.7,76.0,0.1,0.2,0.2,1.7
E06000045,SOUTHAMPTON,114315,113863,96.3,89.9,86.0,10.1,78.7,0.0,0.0,0.6,3.3,0.4,96.6,0.0,110069,102759,98334,11556,89929,0,26,701,3794,456,110372,0,11735,98334,0,26,675,3093,10.3,86.0,0.0,0.0,0.6,2.7
E06000033,SOUTHEND-ON-SEA,86768,86582,96.9,73.6,67.5,21.0,21.0,0.0,0.0,0.0,2.9,0.2,97.3,0.0,84069,63823,58561,18246,18246,0,2,15,2513,186,84422,0,25508,58561,0,2,13,2498,29.4,67.5,0.0,0.0,0.0,2.9
E09000028,SOUTHWARK,150078,149734,93.2,76.9,75.5,43.3,43.3,0.0,0.0,0.3,6.6,0.2,93.2,0.0,139820,115404,113324,65007,65007,0,8,425,9914,342,139881,0,26496,113324,0,8,417,9489,17.7,75.5,0.0,0.0,0.3,6.3
E07000213,SPELTHORNE,44809,44666,97.0,84.0,82.6,23.0,23.0,0.0,0.0,0.6,2.7,0.3,97.6,0.0,43473,37624,37001,10315,10315,0,10,290,1193,142,43752,0,6472,37001,0,10,280,903,14.4,82.6,0.0,0.0,0.6,2.0
E07000240,ST ALBANS,64487,64404,97.3,85.3,83.2,23.4,23.4,0.0,0.1,0.3,2.6,0.1,98.6,0.0,62719,55028,53682,15112,15112,27,65,181,1685,93,63597,0,9037,53682,27,38,116,1504,14.0,83.2,0.0,0.1,0.2,2.3
E08000013,ST. HELENS,87926,87805,97.6,83.7,83.0,4.7,80.6,0.1,0.4,0.6,2.2,0.2,99.2,1.2,85850,73571,72951,4158,70866,58,332,534,1955,133,87233,1052,12899,72951,58,274,202,1421,14.7,83.0,0.1,0.3,0.2,1.6
E07000197,STAFFORD,65059,64983,93.8,62.7,62.6,6.8,9.6,0.3,0.9,2.1,6.0,0.4,98.3,0.7,61047,40823,40713,4415,6238,178,617,1384,3936,267,63977,453,20334,40713,178,439,767,2552,31.3,62.6,0.3,0.7,1.2,3.9
E07000198,STAFFORDSHIRE MOORLANDS,46642,46537,91.7,28.1,27.1,2.9,2.9,0.6,1.7,3.4,8.1,1.3,98.5,0.0,42767,13109,12649,1347,1347,293,784,1579,3770,584,45938,0,30118,12649,293,491,795,2191,64.6,27.1,0.6,1.1,1.7,4.7
E07000243,STEVENAGE,39484,39431,99.2,86.5,86.2,1.3,1.3,0.0,0.0,0.1,0.7,0.1,99.3,0.0,39157,34136,34019,509,509,0,15,34,274,53,39191,0,5138,34019,0,15,19,240,13.0,86.2,0.0,0.0,0.0,0.6
S12000030,STIRLING,46393,45705,88.3,52.1,49.9,48.8,48.8,1.4,3.1,4.9,10.2,3.4,95.7,0.0,40967,24167,23172,22638,22654,648,1437,2277,4738,1575,44396,0,17795,23172,648,789,840,2461,38.4,49.9,1.4,1.7,1.8,5.3
E08000007,STOCKPORT,139538,139160,98.3,83.1,83.0,2.6,28.4,0.0,0.1,0.2,1.5,0.3,99.0,0.0,137135,116021,115788,3675,39677,26,205,282,2025,380,138122,0,21347,115788,26,179,77,1743,15.3,83.0,0.0,0.1,0.1,1.2
E06000004,STOCKTON-ON-TEES,91340,91275,95.9,88.1,84.2,4.6,4.6,0.1,0.5,1.6,4.0,0.2,96.6,3.5,87598,80477,76927,4232,4232,77,444,1442,3677,165,88252,3174,10671,76927,77,367,998,2235,11.7,84.2,0.1,0.4,1.1,2.4
E06000021,STOKE-ON-TRENT,122825,122677,97.7,76.6,75.9,1.0,1.0,0.0,0.1,0.4,2.2,0.1,98.7,0.0,120033,94079,93253,1210,1210,1,76,484,2644,146,121171,0,26780,93253,1,75,408,2160,21.8,75.9,0.0,0.1,0.3,1.8
E07000221,STRATFORD-ON-AVON,65460,65115,93.5,39.9,34.6,12.6,30.3,0.4,1.1,1.9,5.9,0.7,97.8,0.1,61226,26123,22671,8260,19810,261,748,1255,3889,481,64028,47,38555,22671,261,487,507,2634,58.9,34.6,0.4,0.7,0.8,4.0
E07000082,STROUD,56916,56805,89.8,17.3,17.3,13.7,13.7,0.4,1.3,2.7,10.0,0.4,94.7,0.3,51095,9864,9830,7786,7786,242,750,1547,5710,246,53919,184,41265,9830,242,508,797,4163,72.5,17.3,0.4,0.9,1.4,7.3
E08000024,SUNDERLAND,136772,136362,96.5,63.6,59.0,6.9,6.9,0.1,0.2,0.8,3.2,0.4,97.8,0.0,131996,87016,80690,9501,9501,115,338,1129,4366,507,133769,0,51306,80690,115,223,791,3237,37.5,59.0,0.1,0.2,0.6,2.4
E07000214,SURREY HEATH,38615,38583,97.7,66.4,65.6,7.6,7.6,0.0,0.0,0.2,2.2,0.1,99.7,0.0,37716,25628,25317,2939,2939,1,16,90,867,33,38488,0,12399,25317,1,15,74,777,32.1,65.6,0.0,0.0,0.2,2.0
E09000029,SUTTON,87667,87557,98.1,85.6,81.5,6.2,6.2,0.0,0.0,0.3,1.8,0.1,98.3,0.0,86017,75083,71471,5413,5413,13,22,237,1540,109,86216,0,14546,71471,13,9,215,1303,16.6,81.5,0.0,0.0,0.2,1.5
E07000113,SWALE,67277,66961,93.0,42.1,35.4,6.0,6.0,0.2,0.7,1.8,6.5,0.7,98.4,0.0,62559,28316,23794,4047,4047,159,500,1210,4402,440,66176,0,38765,23794,159,341,710,3192,57.6,35.4,0.2,0.5,1.1,4.7
W06000011,SWANSEA,118511,118342,97.6,79.3,76.6,28.2,28.2,0.1,0.2,0.5,2.3,0.2,98.6,51.8,115643,94025,90830,33422,33422,107,260,634,2699,288,116826,61430,24813,90830,107,153,374,2065,20.9,76.6,0.1,0.1,0.3,1.7
E06000030,SWINDON,102038,101996,92.6,81.7,79.3,14.5,14.5,0.0,0.8,2.0,7.3,0.8,93.1,0.0,94511,83370,80966,14757,14757,30,844,2020,7485,777,94980,0,13545,80966,30,814,1176,5465,13.3,79.3,0.0,0.8,1.2,5.4
E08000008,TAMESIDE,115902,115570,97.0,56.5,55.4,16.7,16.7,0.0,0.0,0.2,2.7,0.3,99.3,0.0,112473,65462,64215,19357,19370,3,26,190,3097,330,115107,0,48258,64215,3,23,164,2907,41.6,55.4,0.0,0.0,0.1,2.5
E07000199,TAMWORTH,35253,35192,99.1,85.5,82.0,3.5,79.6,0.1,0.1,0.2,0.7,0.2,99.5,0.0,34938,30131,28924,1231,28053,30,47,77,254,65,35085,0,6014,28924,30,17,30,177,17.1,82.0,0.1,0.0,0.1,0.5
E07000215,TANDRIDGE,38479,38433,93.8,53.3,51.6,11.3,11.3,0.1,0.6,1.0,6.1,0.3,99.5,0.0,36104,20492,19862,4335,4335,43,215,399,2329,103,38290,0,16242,19862,43,172,184,1930,42.2,51.6,0.1,0.4,0.5,5.0
E07000045,TEIGNBRIDGE,66214,66047,88.6,34.1,33.9,8.4,8.4,0.5,1.7,3.7,11.1,1.0,96.6,29.1,58685,22585,22449,5567,5567,300,1133,2439,7362,637,63930,19248,36236,22449,300,833,1306,4923,54.7,33.9,0.5,1.3,2.0,7.4
E06000020,TELFORD AND WREKIN,81898,81714,97.6,79.6,76.8,5.5,5.5,0.1,0.2,0.4,2.2,0.3,99.0,38.5,79952,65182,62915,4511,4511,63,146,326,1762,206,81080,31551,17037,62915,63,83,180,1436,20.8,76.8,0.1,0.1,0.2,1.8
E07000076,TENDRING,74183,74066,95.4,7.6,7.6,7.6,7.6,0.4,1.0,2.0,4.4,0.5,98.0,0.0,70795,5672,5672,5664,5664,296,754,1483,3271,378,72732,0,65123,5672,296,458,729,1788,87.8,7.6,0.4,0.6,1.0,2.4
E07000093,TEST VALLEY,58947,58856,93.5,64.7,63.7,14.7,16.9,0.2,0.8,2.1,6.3,0.7,98.6,0.0,55132,38125,37555,8654,9942,135,498,1227,3724,399,58128,0,17577,37555,135,363,729,2497,29.8,63.7,0.2,0.6,1.2,4.2
E07000083,TEWKESBURY,46454,45971,90.3,57.1,54.8,25.5,25.5,0.3,1.4,2.6,8.6,1.6,92.3,0.0,41954,26520,25463,11840,11840,145,657,1199,4017,721,42888,9,16491,25463,145,512,542,2818,35.5,54.8,0.3,1.1,1.2,6.1
E07000114,THANET,73007,72687,96.6,49.2,49.0,49.1,49.1,0.0,0.1,1.4,2.9,0.5,99.1,0.0,70556,35927,35743,35832,35832,13,103,1024,2131,349,72347,0,34813,35743,13,90,921,1107,47.7,49.0,0.0,0.1,1.3,1.5
E07000102,THREE RIVERS,39477,39451,96.9,78.6,76.2,5.4,5.4,0.2,0.3,0.7,3.0,0.1,99.6,0.0,38259,31046,30074,2145,2145,73,103,258,1192,36,39323,0,8185,30074,73,30,155,934,20.7,76.2,0.2,0.1,0.4,2.4
E06000034,THURROCK,71937,71900,95.8,75.7,74.4,12.8,12.8,0.1,0.5,1.6,4.2,0.2,97.4,0.0,68894,54484,53546,9221,9221,39,344,1154,3006,116,70067,0,15348,53546,39,305,810,1852,21.3,74.4,0.1,0.4,1.1,2.6
E07000115,TONBRIDGE AND MALLING,57130,57033,94.4,61.8,58.7,11.6,11.6,0.2,0.5,1.3,5.4,0.4,98.4,0.0,53955,35282,33512,6632,6632,122,294,727,3078,241,56233,0,20443,33512,122,172,433,2351,35.8,58.7,0.2,0.3,0.8,4.1
E06000027,TORBAY,78494,78101,93.9,65.9,60.6,24.0,24.0,0.0,0.0,0.5,5.6,0.5,96.1,0.2,73686,51701,47606,18858,18858,12,15,394,4415,411,75440,129,26080,47606,12,3,379,4021,33.2,60.6,0.0,0.0,0.5,5.1
W06000020,TORFAEN,45747,45676,96.2,49.3,40.5,11.3,11.3,0.1,0.4,1.2,3.6,0.3,97.7,65.4,44010,22563,18511,5155,5155,55,163,541,1666,160,44674,29937,25499,18511,55,108,378,1125,55.7,40.5,0.1,0.2,0.8,2.5
E07000046,TORRIDGE,34394,34197,80.9,3.5,3.5,3.5,3.5,2.6,7.2,11.5,18.6,2.0,92.5,46.4,27812,1196,1195,1195,1195,899,2465,3952,6385,696,31811,15972,26617,1195,899,1566,1487,2433,77.4,3.5,2.6,4.6,4.3,7.1
E09000030,TOWER HAMLETS,143379,143042,92.4,68.9,65.7,44.3,44.3,0.0,0.0,0.5,7.4,0.2,92.4,0.0,132467,98857,94174,63541,63541,1,33,723,10575,335,132521,0,38293,94174,1,32,690,9852,26.7,65.7,0.0,0.0,0.5,6.9
E08000009,TRAFFORD,107585,107212,97.7,71.1,66.6,2.4,62.9,0.0,0.2,0.3,1.9,0.4,98.9,0.0,105141,76489,71688,2610,67717,49,253,362,2071,385,106372,0,33453,71688,49,204,109,1709,31.1,66.6,0.0,0.2,0.1,1.6
E07000116,TUNBRIDGE WELLS,52445,52343,91.7,49.4,45.2,8.3,8.3,0.1,1.1,2.6,8.1,1.0,98.3,0.0,48093,25897,23724,4337,4337,69,575,1358,4250,530,51579,0,24369,23724,69,506,783,2892,46.5,45.2,0.1,1.0,1.5,5.5
E07000077,UTTLESFORD,40893,40691,87.5,37.9,35.8,19.1,19.1,0.4,1.6,4.3,12.0,1.6,93.4,0.0,35799,15516,14654,7814,7814,171,660,1750,4892,665,38199,0,21145,14654,171,489,1090,3142,51.7,35.8,0.4,1.2,2.7,7.7
W06000014,VALE OF GLAMORGAN,62452,62289,96.4,59.5,55.5,22.5,22.5,0.2,0.9,1.4,3.3,0.6,98.2,10.7,60212,37189,34669,14039,14039,135,586,898,2077,376,61325,6690,25543,34669,135,451,312,1179,40.9,55.5,0.2,0.7,0.5,1.9
E07000180,VALE OF WHITE HORSE,61794,61707,96.2,62.5,60.2,16.5,16.5,0.1,0.3,0.7,3.6,0.2,98.8,0.0,59474,38641,37184,10177,10178,75,196,463,2233,134,61029,0,22290,37184,75,121,267,1770,36.1,60.2,0.1,0.2,0.4,2.9
E08000036,WAKEFIELD,160268,159326,95.6,54.4,53.9,20.4,20.4,0.1,0.3,0.7,3.8,0.6,97.8,0.4,153230,87215,86342,32743,32744,83,508,1062,6096,998,156817,590,66888,86342,83,425,554,5034,41.7,53.9,0.1,0.3,0.3,3.1
E08000030,WALSALL,119103,119019,98.7,78.3,76.1,11.1,73.8,0.0,0.0,0.4,1.3,0.1,99.3,0.0,117506,93218,90653,13242,87890,3,17,458,1513,102,118227,0,26853,90653,3,14,441,1055,22.5,76.1,0.0,0.0,0.4,0.9
E09000031,WALTHAM FOREST,109962,109866,96.8,88.2,87.0,18.0,18.0,0.0,0.0,0.4,3.1,0.1,96.9,0.0,106488,96974,95685,19755,19755,6,10,432,3378,110,106567,0,10803,95685,6,4,422,2946,9.8,87.0,0.0,0.0,0.4,2.7
E09000032,WANDSWORTH,156011,155304,96.9,85.8,79.4,33.4,33.4,0.0,0.0,0.1,2.6,0.4,96.9,0.0,151222,133831,123916,52038,52038,0,14,190,4082,679,151248,0,27306,123916,0,14,176,3892,17.5,79.4,0.0,0.0,0.1,2.5
E06000007,WARRINGTON,99398,99143,96.9,71.2,65.7,1.9,63.2,0.0,0.1,0.2,2.8,0.3,99.2,0.0,96352,70722,65301,1906,62845,33,117,202,2791,278,98607,0,31051,65301,33,84,85,2589,31.2,65.7,0.0,0.1,0.1,2.6
E07000222,WARWICK,69361,69252,97.7,78.6,73.2,9.9,68.9,0.1,0.6,0.8,2.1,0.2,99.2,0.0,67789,54505,50756,6833,47798,87,400,555,1463,141,68794,1,17033,50756,87,313,155,908,24.6,73.2,0.1,0.5,0.2,1.3
E07000103,WATFORD,42417,42135,98.8,90.3,86.5,2.4,2.4,0.0,0.0,0.2,0.6,0.7,98.8,0.0,41895,38299,36696,1000,1000,0,10,65,240,282,41923,0,5199,36696,0,10,55,175,12.3,86.5,0.0,0.0,0.1,0.4
E07000216,WAVERLEY,56506,56440,93.9,19.7,16.2,5.4,5.4,0.1,0.4,0.8,6.0,0.5,99.6,0.0,53040,11122,9152,3036,3036,57,212,441,3400,260,56272,0,43888,9152,57,155,229,2959,77.7,16.2,0.1,0.3,0.4,5.2
E07000065,WEALDEN,73758,73615,93.4,14.6,14.4,14.4,14.4,0.2,0.7,1.4,6.4,0.7,99.4,0.0,68878,10760,10639,10599,10599,157,526,1026,4737,499,73292,0,58239,10639,157,369,500,3711,79.0,14.4,0.2,0.5,0.7,5.0
E07000156,WELLINGBOROUGH,37851,37830,97.5,62.7,62.6,4.1,4.1,0.1,0.5,0.9,2.5,0.1,99.0,14.1,36891,23738,23688,1569,1569,19,184,353,939,56,37474,5337,13203,23688,19,165,169,586,34.9,62.6,0.1,0.4,0.4,1.5
E07000241,WELWYN HATFIELD,50021,49987,97.4,77.2,75.1,9.7,9.7,0.0,0.1,0.3,2.5,0.1,99.3,0.0,48715,38618,37552,4835,4835,7,36,158,1272,40,49687,0,11163,37552,7,29,122,1114,22.3,75.1,0.0,0.1,0.2,2.2
E06000037,WEST BERKSHIRE,71775,71686,97.5,73.5,68.9,26.8,65.2,0.0,0.3,0.6,2.4,0.2,98.6,0.0,69976,52777,49422,19268,46804,29,196,412,1710,146,70790,0,20554,49422,29,167,216,1298,28.6,68.9,0.0,0.2,0.3,1.8
E07000047,WEST DEVON,26998,26908,77.9,22.6,22.6,22.6,22.6,1.8,6.0,11.9,21.7,2.1,95.1,68.2,21037,6099,6099,6099,6099,479,1619,3208,5871,555,25682,18404,14938,6099,479,1140,1589,2663,55.3,22.6,1.8,4.2,5.9,9.9
S12000039,WEST DUNBARTONSHIRE,47053,47033,98.4,89.6,88.2,0.6,86.7,0.1,0.2,0.5,1.6,0.1,99.0,0.0,46284,42173,41486,300,40818,24,95,228,749,30,46602,0,4798,41486,24,71,133,521,10.2,88.2,0.1,0.2,0.3,1.1
E07000127,WEST LANCASHIRE,51743,51676,94.5,44.7,35.2,29.2,29.2,0.2,0.8,1.4,5.4,0.2,98.9,5.5,48898,23148,18205,15093,15112,113,411,719,2778,99,51180,2857,30693,18205,113,298,308,2059,59.3,35.2,0.2,0.6,0.6,4.0
E07000142,WEST LINDSEY,46206,45955,85.5,32.6,30.5,18.7,18.7,2.1,4.5,7.0,14.0,1.6,97.0,26.1,39487,15086,14086,8651,8651,953,2059,3239,6468,731,44815,12079,25401,14086,953,1106,1180,3229,55.0,30.5,2.1,2.4,2.6,7.0
S12000040,WEST LOTHIAN,86073,85967,96.8,68.3,66.8,26.8,66.0,0.2,0.4,0.7,3.1,0.2,99.2,0.0,83321,58794,57515,23089,56830,136,356,622,2646,214,85423,0,25806,57515,136,220,266,2024,30.0,66.8,0.2,0.3,0.3,2.4
E07000181,WEST OXFORDSHIRE,52249,52148,97.8,63.6,56.6,24.9,24.9,0.1,0.3,0.6,2.0,0.3,99.1,0.0,51111,33246,29574,13010,13010,42,131,330,1037,180,51792,0,21537,29574,42,89,199,707,41.2,56.6,0.1,0.2,0.4,1.4
E07000245,WEST SUFFOLK,84358,84272,95.2,30.8,24.5,11.2,11.2,0.1,0.4,0.7,4.7,0.3,99.2,0.1,80337,25942,20636,9434,9434,121,337,580,3935,293,83699,119,59701,20636,121,216,243,3355,70.8,24.5,0.1,0.3,0.3,4.0
E09000033,WESTMINSTER,164654,164145,88.3,61.9,60.8,56.1,56.1,0.0,0.0,0.0,11.4,0.3,88.3,0.0,145358,101877,100037,92327,92327,0,0,56,18787,500,145379,0,45321,100037,0,0,56,18731,27.5,60.8,0.0,0.0,0.0,11.4
E08000010,WIGAN,153742,153674,98.2,84.0,82.9,3.6,11.0,0.0,0.1,0.3,1.7,0.1,99.5,0.1,151013,129177,127519,5504,16955,35,147,410,2661,102,152986,103,23494,127519,35,112,263,2251,15.3,82.9,0.0,0.1,0.2,1.5
E06000054,WILTSHIRE,232820,232458,94.1,43.0,41.5,19.2,19.2,0.2,0.8,1.6,5.8,0.5,98.7,1.0,219056,100201,96688,44743,44743,568,1857,3808,13402,1188,229895,2325,122368,96688,568,1289,1951,9594,52.6,41.5,0.2,0.6,0.8,4.1
E07000094,WINCHESTER,56302,56220,91.8,45.4,35.4,7.9,7.9,0.4,1.2,2.3,8.1,0.7,98.0,0.0,51658,25584,19927,4433,4435,201,691,1306,4562,389,55168,0,31731,19927,201,490,615,3256,56.4,35.4,0.4,0.9,1.1,5.8
E06000040,WINDSOR AND MAIDENHEAD,67437,67377,94.4,62.2,57.7,4.9,4.9,0.2,0.4,1.0,5.5,0.2,98.0,0.0,63677,41942,38926,3298,3299,127,252,653,3700,167,66068,0,24751,38926,127,125,401,3047,36.7,57.7,0.2,0.2,0.6,4.5
E08000015,WIRRAL,158188,158089,97.8,70.7,70.5,41.2,41.2,0.0,0.1,0.2,2.2,0.1,99.6,0.0,154634,111760,111454,65244,65246,31,122,266,3455,105,157507,0,43180,111454,31,91,144,3189,27.3,70.5,0.0,0.1,0.1,2.0
E07000217,WOKING,45217,45126,98.0,84.7,81.7,3.4,3.4,0.0,0.3,0.3,1.8,0.2,99.2,0.0,44332,38321,36962,1544,1544,0,140,157,794,102,44842,0,7370,36962,0,140,17,637,16.3,81.7,0.0,0.3,0.0,1.4
E06000041,WOKINGHAM,76086,74949,93.5,70.2,67.2,12.1,65.0,0.1,0.3,0.8,5.0,1.5,95.9,0.0,71177,53394,51127,9190,49461,66,203,589,3772,1173,72980,0,20050,51127,66,137,386,3183,26.4,67.2,0.1,0.2,0.5,4.2
E08000031,WOLVERHAMPTON,117561,117311,98.4,90.8,89.2,1.8,2.0,0.0,0.0,0.1,1.3,0.2,98.7,5.1,115727,106789,104896,2085,2314,1,3,76,1584,246,116016,5937,10831,104896,1,2,73,1508,9.2,89.2,0.0,0.0,0.1,1.3
E07000237,WORCESTER,48752,48681,98.9,22.1,11.0,2.4,2.4,0.0,0.0,0.0,1.0,0.1,99.5,0.1,48205,10768,5379,1192,1192,0,1,8,476,71,48509,49,42826,5379,0,1,7,468,87.8,11.0,0.0,0.0,0.0,1.0
E07000229,WORTHING,51643,51609,99.3,91.5,90.8,33.6,33.6,0.0,0.0,0.0,0.6,0.1,99.8,0.0,51289,47265,46904,17327,17327,3,4,4,320,34,51521,0,4385,46904,3,1,0,316,8.5,90.8,0.0,0.0,0.0,0.6
W06000006,WREXHAM,65867,65212,94.4,37.3,36.6,36.2,36.2,0.3,1.0,1.8,4.6,1.4,97.2,43.9,62170,24551,24136,23863,23863,194,639,1217,3042,930,64021,28917,38034,24136,194,445,578,1825,57.7,36.6,0.3,0.7,0.9,2.8
E07000238,WYCHAVON,62536,62215,93.8,19.2,15.2,8.0,8.1,0.1,0.7,1.3,5.7,0.8,98.6,0.4,58643,12032,9524,4988,5066,83,423,822,3572,490,61652,225,49119,9524,83,340,399,2750,78.5,15.2,0.1,0.5,0.6,4.4
E07000128,WYRE,56527,56411,95.1,22.7,22.7,22.3,22.3,0.1,0.3,0.7,4.7,0.2,98.8,0.3,53739,12856,12852,12612,12612,61,174,368,2672,133,55837,186,40887,12852,61,113,194,2304,72.3,22.7,0.1,0.2,0.3,4.1
E07000239,WYRE FOREST,48237,48173,96.8,47.9,47.8,2.0,47.8,0.2,0.5,0.8,3.1,0.4,99.5,3.5,46680,23125,23035,961,23034,84,218,389,1493,183,48001,1675,23645,23035,84,134,171,1104,49.0,47.8,0.2,0.3,0.4,2.3
E06000014,YORK,95949,95674,94.1,75.5,71.9,54.8,54.8,0.0,0.2,0.8,5.6,0.3,96.0,3.7,90313,72415,68952,52549,52549,39,209,774,5361,296,92085,3522,21361,68952,39,170,565,4587,22.3,71.9,0.0,0.2,0.6,4.8
