laua,laua_name,All Premises,All Matched Premises,SFBB availability (% premises),UFBB (100Mbit/s) availability (% premises),UFBB availability (% premises),Full Fibre availability (% premises),Gigabit availability (% premises),% of premises unable to receive 2Mbit/s,% of premises unable to receive 5Mbit/s,% of premises unable to receive 10Mbit/s,% of premises unable to receive 30Mbit/s,% of premises below the USO,% of premises with NGA,% of premises able to receive decent broadband from FWA,Number of premises with SFBB availability,Number of premises with UFBB (100Mbit/s) availability,Number of premises with UFBB availability,Number of premises with Full Fibre availability,Number of premises with Gigabit availability,Number of premises unable to receive 2Mbit/s,Number of premises unable to receive 5Mbit/s,Number of premises unable to receive 10Mbit/s,Number of premises unable to receive 30Mbit/s,Number of premises below the USO,Number of premises with NGA,Number of premises able to receive decent broadband from FWA,Number of premises with 30<300Mbit/s download speed,Number of premises with >=300Mbit/s download speed,Number of premises with 0<2Mbit/s download speed,Number of premises with 2<5Mbit/s download speed,Number of premises with 5<10Mbit/s download speed,Number of premises with 10<30Mbit/s download speed,% of premises with 30<300Mbit/s download speed,% of premises with >=300Mbit/s download speed,% of premises with 0<2Mbit/s download speed,% of premises with 2<5Mbit/s download speed,% of premises with 5<10Mbit/s download speed,% of premises with 10<30Mbit/s download speed
S12000033,ABERDEEN CITY,127714,126771,94.7,66.6,62.1,58.4,58.4,0.1,0.2,0.5,4.6,0.1,96.4,0.0,120938,85048,79372,74618,74618,67,211,628,5833,93,123177,0,41566,79372,67,144,417,5205,32.5,62.1,0.1,0.1,0.3,4.1
S12000034,ABERDEENSHIRE,126481,125378,82.8,13.8,13.7,13.7,13.7,2.5,5.7,9.2,16.3,3.7,94.4,0.0,104761,17459,17366,17269,17269,3202,7186,11631,20617,4727,119421,0,87395,17366,3202,3984,4445,8986,69.1,13.7,2.5,3.1,3.5,7.1
E07000223,ADUR,29884,29793,98.6,85.9,85.6,1.8,1.8,0.0,0.0,0.1,1.1,0.0,99.3,0.0,29476,25660,25581,538,538,4,13,36,317,8,29670,0,3895,25581,4,9,23,281,13.0,85.6,0.0,0.0,0.1,0.9
E07000026,ALLERDALE,51933,51622,92.3,3.4,3.4,3.4,3.4,1.1,2.1,3.1,7.1,1.0,98.4,0.0,47922,1750,1750,1750,1750,595,1098,1612,3700,518,51077,0,46172,1750,595,503,514,2088,88.9,3.4,1.1,1.0,1.0,4.0
E07000032,AMBER VALLEY,61555,61161,95.1,31.4,27.9,25.2,25.2,0.1,0.3,0.6,4.3,0.2,98.7,0.0,58516,19334,17177,15512,15512,61,190,379,2645,132,60771,1,41339,17177,61,129,189,2266,67.2,27.9,0.1,0.2,0.3,3.7
S12000041,ANGUS,61105,60447,86.7,23.6,23.5,11.3,11.3,1.4,3.7,6.8,12.2,2.2,95.0,0.0,52987,14438,14351,6934,6934,870,2279,4183,7460,1340,58059,0,38636,14351,870,1409,1904,3277,63.2,23.5,1.4,2.3,3.1,5.4
N09000001,ANTRIM AND NEWTOWNABBEY,60690,59971,92.3,81.1,81.0,72.6,81.0,1.5,2.7,3.3,6.5,1.5,98.6,0.0,56015,49208,49167,44090,49154,933,1617,2018,3956,917,59841,0,6848,49167,933,684,401,1938,11.3,81.0,1.5,1.1,0.7,3.2
N09000011,ARDS AND NORTH DOWN,72688,72463,95.1,81.8,81.8,80.2,81.8,0.6,1.1,1.9,4.6,0.7,99.5,0.0,69095,59464,59460,58289,59460,406,768,1397,3368,512,72312,0,9635,59460,406,362,629,1971,13.3,81.8,0.6,0.5,0.9,2.7
S12000035,ARGYLL AND BUTE,56695,54885,78.1,1.8,1.8,1.8,1.8,3.1,6.0,9.9,18.7,7.3,88.5,0.0,44270,1017,1017,1016,1017,1780,3403,5633,10615,4156,50167,0,43253,1017,1780,1623,2230,4982,76.3,1.8,3.1,2.9,3.9,8.8
N09000002,"ARMAGH CITY, BANBRIDGE AND CRAIGAVON",85913,85418,88.8,68.7,68.7,68.7,68.7,1.4,3.0,4.6,10.6,2.0,98.3,0.2,76281,59056,59012,59055,59055,1238,2558,3934,9137,1736,84426,136,17269,59012,1238,1320,1376,5203,20.1,68.7,1.4,1.5,1.6,6.1
E07000224,ARUN,79522,79179,96.1,17.8,14.1,11.9,11.9,0.1,0.1,0.3,3.5,0.1,99.3,0.0,76399,14169,11202,9425,9425,64,118,268,2780,70,78962,0,65197,11202,64,54,150,2512,82.0,14.1,0.1,0.1,0.2,3.2
E07000170,ASHFIELD,59573,59296,97.9,87.6,87.1,8.6,8.6,0.0,0.4,0.5,1.6,0.0,98.7,0.0,58340,52181,51878,5127,5127,11,216,273,956,23,58823,0,6462,51878,11,205,57,683,10.8,87.1,0.0,0.3,0.1,1.1
E07000105,ASHFORD,59240,58832,90.8,51.7,48.8,11.9,44.8,0.3,1.5,3.1,8.5,0.7,98.0,34.8,53794,30656,28923,7045,26511,166,910,1855,5038,433,58076,20602,24871,28923,166,744,945,3183,42.0,48.8,0.3,1.3,1.6,5.4
E07000200,BABERGH,43587,43170,93.3,16.0,15.8,11.7,11.7,0.3,0.7,1.1,5.7,0.4,98.3,8.0,40670,6994,6879,5102,5102,144,324,484,2500,192,42863,3487,33791,6879,144,180,160,2016,77.5,15.8,0.3,0.4,0.4,4.6
E09000002,BARKING AND DAGENHAM,80564,80487,98.5,90.3,90.2,52.0,89.1,0.0,0.4,0.8,1.4,0.0,98.5,0.0,79342,72777,72653,41929,71797,24,339,612,1145,20,79364,0,6689,72653,24,315,273,533,8.3,90.2,0.0,0.4,0.3,0.7
E09000003,BARNET,160129,159573,97.2,62.1,58.9,23.2,56.6,0.0,0.0,0.1,2.4,0.0,98.2,0.0,155713,99519,94260,37214,90700,0,22,163,3860,12,157264,0,61453,94260,0,22,141,3697,38.4,58.9,0.0,0.0,0.1,2.3
E08000016,BARNSLEY,118373,117865,97.9,70.1,67.2,24.7,24.7,0.1,0.2,0.4,1.7,0.0,98.9,10.8,115890,83001,79576,29287,29290,90,274,430,1975,20,117083,12759,36314,79576,90,184,156,1545,30.7,67.2,0.1,0.2,0.1,1.3
E07000027,BARROW-IN-FURNESS,35656,35522,98.2,5.2,5.2,5.2,5.2,0.2,0.2,0.4,1.4,0.1,99.6,0.3,35014,1841,1841,1841,1841,54,81,133,508,35,35510,101,33173,1841,54,27,52,375,93.0,5.2,0.2,0.1,0.1,1.1
E07000066,BASILDON,83748,83502,97.9,81.5,79.3,29.4,29.4,0.0,0.2,0.5,1.8,0.0,99.2,0.0,82030,68261,66372,24596,24596,24,151,384,1472,11,83052,0,15658,66372,24,127,233,1088,18.7,79.3,0.0,0.2,0.3,1.3
E07000084,BASINGSTOKE AND DEANE,82412,82051,95.5,59.2,57.1,28.9,56.8,0.2,0.5,1.0,4.1,0.4,98.0,0.0,78672,48828,47085,23808,46835,130,440,832,3379,317,80766,0,31587,47085,130,310,392,2547,38.3,57.1,0.2,0.4,0.5,3.1
E07000171,BASSETLAW,57393,56911,95.2,35.5,33.7,10.2,10.2,0.4,0.8,1.2,3.9,0.3,98.5,21.7,54645,20381,19320,5880,5881,233,440,712,2266,184,56540,12428,35325,19320,233,207,272,1554,61.5,33.7,0.4,0.4,0.5,2.7
E06000022,BATH AND NORTH EAST SOMERSET,89008,88610,94.0,67.8,61.4,33.6,33.7,0.1,0.2,0.6,5.6,0.1,96.0,0.0,83666,60315,54618,29933,29975,98,197,556,4944,132,85490,1,29048,54618,98,99,359,4388,32.6,61.4,0.1,0.1,0.4,4.9
E06000055,BEDFORD,82088,81811,96.8,77.0,73.6,16.4,35.5,0.2,0.4,0.8,2.9,0.1,98.6,0.0,79466,63207,60414,13459,29139,134,332,634,2345,91,80930,1,19052,60414,134,198,302,1711,23.2,73.6,0.2,0.2,0.4,2.1
N09000003,BELFAST,167277,166000,98.1,92.5,92.3,80.1,92.3,0.0,0.1,0.3,1.1,0.3,98.3,0.0,164119,154760,154377,134027,154378,41,123,570,1881,532,164401,0,9742,154377,41,82,447,1311,5.8,92.3,0.0,0.0,0.3,0.8
E09000004,BEXLEY,103683,103383,97.5,82.3,81.3,45.0,80.8,0.0,0.1,0.6,2.2,0.0,98.1,0.0,101124,85346,84304,46677,83731,3,104,626,2259,6,101713,0,16820,84304,3,101,522,1633,16.2,81.3,0.0,0.1,0.5,1.6
E08000025,BIRMINGHAM,474961,471159,95.2,89.9,88.6,38.7,88.0,0.0,0.1,0.8,4.0,0.0,95.3,0.0,452173,426787,420836,183851,417774,33,678,3571,18986,57,452539,0,31337,420836,33,645,2893,15415,6.6,88.6,0.0,0.1,0.6,3.2
E07000129,BLABY,45540,45416,97.7,72.7,70.0,33.5,33.5,0.1,0.2,0.3,2.1,0.0,98.7,0.0,44479,33103,31888,15265,15265,32,97,141,937,16,44956,0,12591,31888,32,65,44,796,27.6,70.0,0.1,0.1,0.1,1.7
E06000008,BLACKBURN WITH DARWEN,67629,67273,97.2,69.3,68.8,11.7,11.8,0.0,0.2,0.4,2.3,0.0,98.7,69.9,65742,46840,46550,7939,7957,22,154,268,1531,33,66742,47244,19192,46550,22,132,114,1263,28.4,68.8,0.0,0.2,0.2,1.9
E06000009,BLACKPOOL,77800,77529,98.4,71.0,70.8,0.9,0.9,0.0,0.0,0.0,1.3,0.0,98.6,9.0,76532,55244,55068,736,737,1,10,33,997,1,76676,7026,21464,55068,1,9,23,964,27.6,70.8,0.0,0.0,0.0,1.2
W06000019,BLAENAU GWENT,35332,35200,96.2,5.3,3.9,2.8,2.8,0.0,0.3,0.7,3.4,0.2,99.2,0.1,33986,1888,1379,974,974,15,93,238,1214,55,35041,18,32607,1379,15,78,145,976,92.3,3.9,0.0,0.2,0.4,2.8
E07000033,BOLSOVER,39144,38984,94.4,42.9,38.0,15.0,15.0,0.0,0.2,0.3,5.2,0.1,98.3,0.0,36967,16805,14868,5860,5860,16,59,137,2017,54,38497,0,22099,14868,16,43,78,1880,56.5,38.0,0.0,0.1,0.2,4.8
E08000001,BOLTON,133889,133286,98.1,88.0,86.4,13.1,85.3,0.0,0.1,0.3,1.4,0.1,98.9,3.4,131345,117827,115746,17534,114245,23,132,346,1941,67,132443,4588,15599,115746,23,109,214,1595,11.7,86.4,0.0,0.1,0.2,1.2
E07000136,BOSTON,33401,33141,91.3,9.3,9.3,9.3,9.3,0.6,1.4,2.2,7.9,0.6,97.4,34.0,30489,3121,3120,3121,3121,213,474,743,2652,207,32516,11342,27369,3120,213,261,269,1909,81.9,9.3,0.6,0.8,0.8,5.7
E06000058,"BOURNEMOUTH, CHRISTCHURCH AND POOLE",198639,197291,97.9,82.0,79.6,31.8,47.7,0.2,0.2,0.3,1.4,0.1,98.8,0.2,194513,162961,158189,63121,94740,332,373,625,2778,127,196310,315,36324,158189,332,41,252,2153,18.3,79.6,0.2,0.0,0.1,1.1
E06000036,BRACKNELL FOREST,54677,54373,96.2,63.3,59.7,12.1,57.7,0.0,0.1,0.7,3.2,0.1,97.6,0.0,52599,34614,32644,6635,31552,14,55,380,1774,34,53379,3,19955,32644,14,41,325,1394,36.5,59.7,0.0,0.1,0.6,2.5
E08000032,BRADFORD,221171,220206,96.4,82.2,80.0,7.9,76.8,0.1,0.2,0.4,3.2,0.0,97.8,31.6,213128,181745,177005,17464,169849,145,470,949,7078,27,216229,69904,36123,177005,145,325,479,6129,16.3,80.0,0.1,0.1,0.2,2.8
E07000067,BRAINTREE,71310,70882,95.2,24.5,24.5,24.5,24.5,0.3,0.6,1.1,4.2,0.3,97.7,11.3,67856,17496,17496,17462,17462,191,460,762,3026,189,69658,8087,50360,17496,191,269,302,2264,70.6,24.5,0.3,0.4,0.4,3.2
E07000143,BRECKLAND,66646,66296,90.9,32.4,30.8,29.5,29.5,0.7,1.7,2.9,8.6,1.8,97.8,0.0,60580,21598,20521,19692,19692,455,1141,1938,5716,1171,65185,2,40059,20521,455,686,797,3778,60.1,30.8,0.7,1.0,1.2,5.7
E09000005,BRENT,138200,136659,96.2,77.8,74.8,39.1,73.5,0.0,0.3,0.7,2.7,0.0,96.2,0.0,132911,107459,103422,54038,101615,3,439,1005,3748,1,132976,0,29489,103422,3,436,566,2743,21.3,74.8,0.0,0.3,0.4,2.0
E07000068,BRENTWOOD,35725,35437,95.2,42.2,42.2,42.2,42.2,0.1,0.3,0.6,3.9,0.2,98.2,0.1,34026,15082,15081,15080,15080,31,113,231,1411,54,35095,46,18945,15081,31,82,118,1180,53.0,42.2,0.1,0.2,0.3,3.3
W06000013,BRIDGEND,67650,67383,97.2,46.9,39.5,35.0,35.0,0.0,0.1,0.5,2.4,0.0,98.9,36.3,65742,31706,26742,23660,23685,33,84,347,1641,16,66932,24552,39000,26742,33,51,263,1294,57.6,39.5,0.0,0.1,0.4,1.9
E06000043,BRIGHTON AND HOVE,142905,141453,97.0,84.3,80.8,14.2,14.2,0.0,0.1,0.7,2.0,0.0,97.2,0.0,138593,120489,115400,20262,20263,4,212,981,2860,9,138885,1,23193,115400,4,208,769,1879,16.2,80.8,0.0,0.1,0.5,1.3
E06000023,"BRISTOL, CITY OF",211568,210091,95.6,90.0,89.0,50.4,83.1,0.0,0.1,0.5,3.7,0.1,95.8,0.0,202334,190342,188379,106588,175903,12,150,997,7757,232,202668,38,13955,188379,12,138,847,6760,6.6,89.0,0.0,0.1,0.4,3.2
E07000144,BROADLAND,61660,61363,94.1,44.4,41.0,8.7,8.7,0.3,0.7,1.4,5.4,1.2,98.5,0.0,58020,27364,25265,5353,5360,170,461,894,3343,714,60705,0,32755,25265,170,291,433,2449,53.1,41.0,0.3,0.5,0.7,4.0
E09000006,BROMLEY,146753,146430,97.7,88.2,87.9,21.4,87.2,0.0,0.2,0.4,2.1,0.0,98.6,0.0,143393,129435,129042,31368,127908,51,313,600,3037,61,144658,0,14351,129042,51,262,287,2437,9.8,87.9,0.0,0.2,0.2,1.7
E07000234,BROMSGROVE,45158,44898,96.9,73.7,73.6,53.6,73.6,0.0,0.3,0.6,2.5,0.1,99.1,0.1,43774,33281,33245,24196,33245,21,135,256,1124,60,44753,41,10529,33245,21,114,121,868,23.3,73.6,0.0,0.3,0.3,1.9
E07000095,BROXBOURNE,43132,43075,98.6,88.1,84.6,5.3,5.3,0.1,0.1,0.2,1.3,0.0,99.3,0.0,42519,37999,36479,2273,2273,25,35,98,556,3,42819,0,6040,36479,25,10,63,458,14.0,84.6,0.1,0.0,0.1,1.1
E07000172,BROXTOWE,52418,52267,98.7,91.6,90.7,11.6,11.6,0.0,0.1,0.2,1.0,0.0,99.4,0.0,51747,48039,47561,6062,6062,14,51,103,520,3,52094,0,4186,47561,14,37,52,417,8.0,90.7,0.0,0.1,0.1,0.8
E06000060,BUCKINGHAMSHIRE,241658,240108,94.4,54.4,49.2,20.4,37.3,0.1,0.7,1.5,5.0,0.3,97.9,0.1,228136,131393,119003,49247,90178,274,1717,3526,11972,729,236699,225,109133,119003,274,1443,1809,8446,45.2,49.2,0.1,0.6,0.7,3.5
E07000117,BURNLEY,45504,45290,97.8,79.0,79.0,1.9,79.0,0.1,0.1,0.3,1.7,0.0,99.1,61.2,44499,35940,35932,857,35931,31,50,123,791,15,45104,27833,8567,35932,31,19,73,668,18.8,79.0,0.1,0.0,0.2,1.5
E08000002,BURY,89944,88683,97.4,77.8,73.7,59.9,69.8,0.0,0.1,0.2,1.2,0.2,98.5,0.0,87591,70012,66245,53864,62806,11,81,151,1092,139,88588,0,21346,66245,11,70,70,941,23.7,73.7,0.0,0.1,0.1,1.0
W06000018,CAERPHILLY,83507,83151,97.9,33.2,30.5,28.6,28.6,0.1,0.1,0.2,1.7,0.0,99.4,46.8,81770,27724,25475,23909,23916,42,107,208,1381,34,82984,39105,56295,25475,42,65,101,1173,67.4,30.5,0.1,0.1,0.1,1.4
E08000033,CALDERDALE,103810,103274,94.6,52.2,52.1,14.3,14.3,0.1,0.4,0.7,4.9,0.1,98.3,0.0,98180,54227,54069,14800,14801,111,376,699,5094,76,102023,27,44111,54069,111,265,323,4395,42.5,52.1,0.1,0.3,0.3,4.2
E07000008,CAMBRIDGE,60178,60029,98.6,92.1,90.0,40.9,40.9,0.0,0.0,0.1,1.1,0.0,98.7,0.0,59361,55405,54148,24594,24594,1,20,77,668,2,59393,0,5213,54148,1,19,57,591,8.7,90.0,0.0,0.0,0.1,1.0
E09000007,CAMDEN,122119,120911,96.8,91.5,89.9,59.9,90.0,0.0,0.0,0.0,2.2,0.0,96.8,0.0,118183,111703,109798,73188,109904,0,0,8,2728,0,118187,3,8385,109798,0,0,8,2720,6.9,89.9,0.0,0.0,0.0,2.2
E07000192,CANNOCK CHASE,48031,47774,97.5,36.8,36.7,15.5,36.5,0.0,0.1,0.2,2.0,0.1,99.2,0.0,46810,17664,17619,7437,17555,16,38,105,964,58,47632,0,29191,17619,16,22,67,859,60.8,36.7,0.0,0.0,0.1,1.8
E07000106,CANTERBURY,73862,73401,93.6,10.7,10.7,10.7,10.7,0.2,0.5,1.1,5.8,0.2,99.0,14.7,69108,7910,7909,7910,7910,154,406,776,4293,170,73109,10856,61199,7909,154,252,370,3517,82.9,10.7,0.2,0.3,0.5,4.8
W06000015,CARDIFF,166560,165693,97.5,86.3,83.9,47.9,82.3,0.0,0.2,0.5,2.0,0.0,98.0,61.9,162417,143748,139726,79705,137136,32,333,866,3276,22,163206,103019,22691,139726,32,301,533,2410,13.6,83.9,0.0,0.2,0.3,1.4
E07000028,CARLISLE,57604,57228,94.0,54.6,48.3,6.5,6.5,0.7,1.5,2.5,5.4,1.2,97.6,0.0,54140,31475,27831,3736,3736,409,863,1416,3088,690,56242,18,26309,27831,409,454,553,1672,45.7,48.3,0.7,0.8,1.0,2.9
W06000010,CARMARTHENSHIRE,93442,92347,86.5,33.0,33.0,33.0,33.0,1.9,4.2,6.5,12.3,2.4,93.0,1.1,80815,30878,30878,30874,30878,1767,3914,6103,11532,2257,86943,1071,49937,30878,1767,2147,2189,5429,53.4,33.0,1.9,2.3,2.3,5.8
E07000069,CASTLE POINT,41073,40716,98.3,44.2,44.2,2.8,2.8,0.0,0.1,0.2,0.8,0.0,98.8,0.0,40380,18157,18135,1164,1164,13,41,66,336,8,40565,0,22245,18135,13,28,25,270,54.2,44.2,0.0,0.1,0.1,0.7
N09000004,CAUSEWAY COAST AND GLENS,66059,64583,87.1,64.4,64.4,64.4,64.4,1.9,3.6,4.9,10.6,3.1,97.3,0.0,57552,42523,42521,42519,42521,1269,2392,3256,7031,2070,64275,0,15031,42521,1269,1123,864,3775,22.8,64.4,1.9,1.7,1.3,5.7
E06000056,CENTRAL BEDFORDSHIRE,135595,130828,93.9,71.3,68.6,20.9,20.9,0.1,0.4,0.8,2.5,0.5,95.9,0.2,127384,96626,93064,28275,28354,131,567,1047,3444,628,129992,273,34320,93064,131,436,480,2397,25.3,68.6,0.1,0.3,0.4,1.8
W06000008,CEREDIGION,37692,37326,81.2,21.8,21.8,21.8,21.8,2.8,6.4,10.6,17.8,4.5,89.3,0.4,30609,8230,8230,8230,8230,1074,2428,4004,6717,1702,33648,156,22379,8230,1074,1354,1576,2713,59.4,21.8,2.8,3.6,4.2,7.2
E07000130,CHARNWOOD,79866,79645,98.4,76.0,72.9,16.0,16.0,0.1,0.2,0.4,1.3,0.1,99.4,0.0,78570,60665,58259,12798,12798,93,181,331,1075,79,79363,0,20311,58259,93,88,150,744,25.4,72.9,0.1,0.1,0.2,0.9
E07000070,CHELMSFORD,82549,82265,95.2,64.0,61.2,41.8,41.8,0.1,0.4,0.8,4.4,0.1,98.1,1.4,78618,52856,50487,34507,34507,49,331,663,3647,112,81018,1174,28131,50487,49,282,332,2984,34.1,61.2,0.1,0.3,0.4,3.6
E07000078,CHELTENHAM,60189,60016,98.7,76.0,68.6,4.5,63.4,0.0,0.1,0.3,1.0,0.0,99.0,0.0,59391,45772,41318,2705,38130,17,55,159,625,5,59616,0,18073,41318,17,38,104,466,30.0,68.6,0.0,0.1,0.2,0.8
E07000177,CHERWELL,72202,71576,96.0,50.5,41.6,14.6,14.6,0.3,0.5,1.0,3.1,0.2,98.1,0.4,69323,36442,30071,10576,10576,189,351,746,2253,128,70798,254,39252,30071,189,162,395,1507,54.4,41.6,0.3,0.2,0.5,2.1
E06000049,CHESHIRE EAST,191689,190656,94.0,51.9,45.9,18.1,26.0,0.3,0.8,1.5,5.5,0.3,98.2,3.9,180114,99515,87966,34666,49819,529,1465,2826,10542,632,188216,7524,92148,87966,529,936,1361,7716,48.1,45.9,0.3,0.5,0.7,4.0
E06000050,CHESHIRE WEST AND CHESTER,170402,169770,95.2,55.3,48.9,31.8,31.8,0.1,0.6,1.1,4.4,0.2,98.7,0.5,162196,94307,83352,54254,54254,244,992,1959,7574,338,168119,770,78844,83352,244,748,967,5615,46.3,48.9,0.1,0.4,0.6,3.3
E07000034,CHESTERFIELD,53481,53294,97.0,54.8,54.2,23.8,23.8,0.0,0.0,0.2,2.7,0.0,98.9,0.0,51862,29333,28986,12748,12748,0,14,100,1432,5,52904,0,22876,28986,0,14,86,1332,42.8,54.2,0.0,0.0,0.2,2.5
E07000225,CHICHESTER,62718,61911,90.3,25.9,23.6,22.0,22.0,0.3,0.9,2.0,8.4,0.9,97.9,0.0,56622,16234,14823,13829,13829,201,582,1237,5289,590,61408,0,41799,14823,201,381,655,4052,66.6,23.6,0.3,0.6,1.0,6.5
E07000118,CHORLEY,55031,54767,95.8,64.4,61.4,19.2,19.2,0.1,0.2,0.6,3.7,0.1,98.9,35.2,52741,35458,33772,10545,10546,28,123,329,2026,50,54443,19361,18969,33772,28,95,206,1697,34.5,61.4,0.1,0.2,0.4,3.1
S12000036,CITY OF EDINBURGH,266242,265798,97.6,88.6,86.8,53.8,85.8,0.0,0.2,0.4,2.2,0.0,98.0,0.0,259916,235796,231028,143123,228362,113,423,1029,5882,55,261018,5,28888,231028,113,310,606,4853,10.9,86.8,0.0,0.1,0.2,1.8
E09000001,CITY OF LONDON,10887,10727,56.5,47.7,47.0,46.3,47.0,0.0,0.0,0.0,42.0,0.0,56.5,0.0,6154,5192,5122,5044,5119,0,0,0,4573,1,6154,1,1032,5122,0,0,0,4573,9.5,47.0,0.0,0.0,0.0,42.0
S12000005,CLACKMANNANSHIRE,25947,25814,95.5,34.9,25.1,21.1,21.1,0.1,0.2,0.4,4.0,0.2,99.3,0.0,24785,9059,6514,5474,5474,29,50,106,1029,40,25760,0,18271,6514,29,21,56,923,70.4,25.1,0.1,0.1,0.2,3.6
E07000071,COLCHESTER,88324,87438,95.8,61.0,60.9,15.9,15.9,0.1,0.7,1.0,3.2,0.2,97.5,7.6,84591,53914,53769,14034,14034,100,583,925,2847,146,86144,6701,30822,53769,100,483,342,1922,34.9,60.9,0.1,0.5,0.4,2.2
W06000003,CONWY,59437,59293,94.2,10.1,10.1,10.1,10.1,0.7,1.7,2.9,5.5,1.2,97.6,58.3,55999,6020,6020,6020,6020,427,1018,1724,3294,725,57986,34645,49979,6020,427,591,706,1570,84.1,10.1,0.7,1.0,1.2,2.6
E07000029,COPELAND,35763,35589,94.6,1.9,1.9,1.9,1.9,0.3,0.8,1.4,4.9,1.2,98.9,0.0,33820,668,668,668,668,116,269,499,1769,439,35360,0,33152,668,116,153,230,1270,92.7,1.9,0.3,0.4,0.6,3.6
E06000052,CORNWALL,302039,298727,86.9,36.8,35.5,32.6,32.6,0.3,1.0,2.4,12.0,0.8,92.3,4.5,262390,111073,107179,98588,98588,937,3069,7188,36337,2542,278806,13465,155211,107179,937,2132,4119,29149,51.4,35.5,0.3,0.7,1.4,9.7
E07000079,COTSWOLD,47703,47331,93.1,39.6,39.3,39.2,39.2,0.1,0.6,1.4,6.1,0.8,95.1,0.2,44420,18878,18740,18684,18685,60,298,657,2911,395,45347,83,25680,18740,60,238,359,2254,53.8,39.3,0.1,0.5,0.8,4.7
E06000047,COUNTY DURHAM,260440,259407,94.4,43.4,40.6,37.6,37.6,0.3,0.8,1.4,5.2,0.4,98.8,0.1,245820,112915,105843,97852,97852,863,2072,3530,13587,963,257330,178,139977,105843,863,1209,1458,10057,53.7,40.6,0.3,0.5,0.6,3.9
E08000026,COVENTRY,149032,148442,98.3,94.4,94.1,91.5,94.1,0.0,0.3,0.5,1.3,0.0,98.4,0.0,146531,140652,140237,136380,140241,4,414,682,1911,11,146644,0,6294,140237,4,410,268,1229,4.2,94.1,0.0,0.3,0.2,0.8
E07000163,CRAVEN,30353,30088,92.5,23.3,18.0,13.1,13.2,1.0,1.7,2.7,6.7,0.7,97.3,44.9,28069,7070,5450,3986,3999,299,522,832,2019,202,29548,13624,22619,5450,299,223,310,1187,74.5,18.0,1.0,0.7,1.0,3.9
E07000226,CRAWLEY,49420,49344,98.7,85.8,84.8,6.7,6.8,0.0,0.1,0.3,1.1,0.0,99.3,0.0,48785,42394,41894,3327,3343,6,45,132,559,5,49053,0,6891,41894,6,39,87,427,13.9,84.8,0.0,0.1,0.2,0.9
E09000008,CROYDON,169191,168357,95.9,85.2,84.1,28.0,84.0,0.0,0.1,0.3,3.6,0.0,96.5,0.0,162284,144072,142284,47456,142165,1,90,503,6073,25,163280,0,20000,142284,1,89,413,5570,11.8,84.1,0.0,0.1,0.2,3.3
E07000096,DACORUM,69128,68837,96.5,77.4,75.4,19.1,19.1,0.1,0.4,0.7,3.1,0.1,98.7,0.0,66727,53533,52156,13221,13222,89,265,455,2110,70,68222,0,14571,52156,89,176,190,1655,21.1,75.4,0.1,0.3,0.3,2.4
E06000005,DARLINGTON,54733,54599,95.1,84.5,84.1,3.7,3.7,0.7,1.8,2.7,4.7,0.2,96.6,11.2,52047,46237,46010,2003,2018,369,976,1470,2552,99,52865,6130,6037,46010,369,607,494,1082,11.0,84.1,0.7,1.1,0.9,2.0
E07000107,DARTFORD,50193,50111,96.8,75.2,73.6,40.0,72.2,0.3,0.6,1.0,3.0,0.0,98.6,0.0,48597,37761,36947,20055,36221,142,310,481,1514,8,49475,0,11650,36947,142,168,171,1033,23.2,73.6,0.3,0.3,0.3,2.1
W06000004,DENBIGHSHIRE,50084,49588,90.2,23.6,23.6,23.6,23.6,0.8,1.9,3.9,8.8,1.2,94.4,30.5,45173,11822,11822,11822,11822,398,973,1955,4415,588,47284,15257,33351,11822,398,575,982,2460,66.6,23.6,0.8,1.1,2.0,4.9
E06000015,DERBY,119722,119327,98.6,93.3,92.3,46.9,46.9,0.0,0.0,0.2,1.1,0.0,98.8,0.0,118023,111720,110520,56142,56181,12,33,180,1304,0,118242,0,7503,110520,12,21,147,1124,6.3,92.3,0.0,0.0,0.1,0.9
E07000035,DERBYSHIRE DALES,37658,37388,89.4,9.4,9.4,9.4,9.4,0.5,1.8,3.7,9.9,1.5,96.5,0.0,33650,3533,3533,3533,3533,202,678,1379,3738,554,36337,0,30117,3533,202,476,701,2359,80.0,9.4,0.5,1.3,1.9,6.3
N09000005,DERRY CITY AND STRABANE,62565,62279,91.0,79.5,79.5,70.7,79.5,2.2,3.5,4.6,8.5,2.7,98.8,0.0,56964,49762,49758,44260,49758,1380,2162,2884,5315,1667,61820,0,7206,49758,1380,782,722,2431,11.5,79.5,2.2,1.2,1.2,3.9
E08000017,DONCASTER,147381,146682,97.6,63.9,63.7,49.3,49.3,0.1,0.2,0.5,2.0,0.1,98.8,22.6,143782,94202,93946,72711,72711,101,353,784,2900,82,145571,33268,49836,93946,101,252,431,2116,33.8,63.7,0.1,0.2,0.3,1.4
E06000059,DORSET,190575,189229,92.8,15.9,15.4,12.9,12.9,0.2,0.6,1.2,6.5,0.4,98.1,2.7,176812,30335,29264,24592,24593,315,1167,2283,12417,781,186923,5233,147548,29264,315,852,1116,10134,77.4,15.4,0.2,0.4,0.6,5.3
E07000108,DOVER,55960,55636,93.2,45.3,45.3,19.1,19.1,0.3,0.7,1.6,6.3,0.2,98.2,32.7,52135,25338,25335,10707,10707,189,412,868,3501,126,54927,18306,26800,25335,189,223,456,2633,47.9,45.3,0.3,0.4,0.8,4.7
E08000027,DUDLEY,147789,147321,98.8,91.1,89.8,5.0,88.5,0.0,0.0,0.0,0.8,0.0,99.3,4.4,146074,134577,132733,7439,130864,1,12,73,1247,17,146713,6485,13341,132733,1,11,61,1174,9.0,89.8,0.0,0.0,0.0,0.8
S12000006,DUMFRIES AND GALLOWAY,82696,81120,85.4,8.0,8.0,8.0,8.0,1.7,3.7,6.6,12.7,3.5,95.2,0.0,70622,6616,6615,6615,6615,1384,3097,5421,10498,2921,78714,0,64007,6615,1384,1713,2324,5077,77.4,8.0,1.7,2.1,2.8,6.1
S12000042,DUNDEE CITY,79844,79698,98.6,90.6,88.3,23.3,23.3,0.0,0.0,0.2,1.2,0.0,99.1,0.0,78704,72299,70533,18623,18623,1,13,131,994,0,79106,0,8171,70533,1,12,118,863,10.2,88.3,0.0,0.0,0.1,1.1
E09000009,EALING,150082,148822,97.3,75.3,73.2,16.1,73.3,0.0,0.1,0.7,1.9,0.0,97.3,0.0,145962,113007,109901,24190,110052,3,135,1069,2860,39,145989,0,36061,109901,3,132,934,1791,24.0,73.2,0.0,0.1,0.6,1.2
S12000008,EAST AYRSHIRE,60659,60420,95.4,47.6,47.1,39.5,39.5,0.6,1.2,2.0,4.2,0.4,98.6,0.0,57857,28904,28557,23959,23959,381,713,1207,2563,234,59790,0,29300,28557,381,332,494,1356,48.3,47.1,0.6,0.5,0.8,2.2
E07000009,EAST CAMBRIDGESHIRE,40247,39766,94.9,47.6,41.4,27.9,27.9,0.4,0.8,1.4,3.9,0.4,98.2,0.7,38178,19176,16660,11241,11241,144,318,576,1588,170,39542,263,21518,16660,144,174,258,1012,53.5,41.4,0.4,0.4,0.6,2.5
E07000040,EAST DEVON,75467,75015,89.4,39.2,38.4,38.0,38.0,0.5,2.0,3.8,10.0,0.8,96.2,14.9,67452,29562,28990,28675,28675,387,1492,2859,7563,591,72566,11266,38462,28990,387,1105,1367,4704,51.0,38.4,0.5,1.5,1.8,6.2
S12000045,EAST DUNBARTONSHIRE,50461,50134,96.3,81.5,80.5,22.7,79.7,0.0,0.2,0.6,3.1,0.0,98.3,0.0,48590,41115,40601,11444,40242,24,109,284,1544,15,49595,0,7989,40601,24,85,175,1260,15.8,80.5,0.0,0.2,0.3,2.5
E07000085,EAST HAMPSHIRE,58147,57513,92.4,48.0,45.6,19.6,19.6,0.2,0.5,1.2,6.5,0.5,96.8,0.0,53742,27908,26518,11381,11381,96,305,696,3771,285,56309,0,27224,26518,96,209,391,3075,46.8,45.6,0.2,0.4,0.7,5.3
E07000242,EAST HERTFORDSHIRE,67186,66966,95.5,70.1,66.9,12.6,12.6,0.1,0.4,0.8,4.2,0.4,97.9,0.0,64171,47093,44958,8475,8475,94,286,555,2795,241,65747,2,19213,44958,94,192,269,2240,28.6,66.9,0.1,0.3,0.4,3.3
E07000137,EAST LINDSEY,73024,72392,87.8,19.7,16.1,4.9,4.9,0.9,2.5,4.6,11.4,0.9,96.9,33.6,64091,14410,11749,3554,3555,667,1840,3340,8301,659,70785,24544,52342,11749,667,1173,1500,4961,71.7,16.1,0.9,1.6,2.1,6.8
S12000010,EAST LOTHIAN,49334,49132,92.5,33.4,33.4,33.4,33.4,0.4,1.4,2.4,7.1,0.3,97.4,36.1,45621,16482,16480,16478,16482,199,706,1197,3511,165,48075,17805,29141,16480,199,507,491,2314,59.1,33.4,0.4,1.0,1.0,4.7
S12000011,EAST RENFREWSHIRE,41194,41172,95.9,70.9,70.4,9.1,70.3,0.1,0.2,0.6,4.1,0.1,98.9,0.0,39501,29191,28983,3759,28946,38,99,233,1671,41,40751,0,10518,28983,38,61,134,1438,25.5,70.4,0.1,0.1,0.3,3.5
E06000011,EAST RIDING OF YORKSHIRE,167403,166030,95.9,69.6,68.9,68.4,68.4,0.4,0.9,1.4,3.3,0.2,98.4,44.9,160517,116531,115392,114561,114563,739,1498,2343,5513,341,164704,75206,45125,115392,739,759,845,3170,27.0,68.9,0.4,0.5,0.5,1.9
E07000193,EAST STAFFORDSHIRE,56418,55999,94.6,40.0,36.4,32.3,32.3,0.3,0.8,1.4,4.7,0.3,98.5,0.0,53374,22583,20524,18230,18230,155,430,805,2625,163,55596,0,32850,20524,155,275,375,1820,58.2,36.4,0.3,0.5,0.7,3.2
E07000244,EAST SUFFOLK,127456,126321,93.8,23.6,23.6,17.2,17.2,0.2,0.7,1.2,5.3,0.5,97.9,1.7,119599,30121,30069,21957,21957,199,831,1525,6722,690,124808,2119,89530,30069,199,632,694,5197,70.2,23.6,0.2,0.5,0.5,4.1
E07000061,EASTBOURNE,51028,50856,98.9,22.6,22.6,22.6,22.6,0.0,0.0,0.1,0.8,0.0,99.4,0.0,50472,11549,11549,11549,11549,1,13,53,384,3,50702,0,38923,11549,1,12,40,331,76.3,22.6,0.0,0.0,0.1,0.6
E07000086,EASTLEIGH,61332,61105,97.2,75.7,72.7,16.0,25.1,0.0,0.0,0.2,2.4,0.0,98.7,0.0,59618,46445,44600,9815,15423,1,10,112,1487,5,60548,0,15018,44600,1,9,102,1375,24.5,72.7,0.0,0.0,0.2,2.2
E07000030,EDEN,30111,29659,80.6,6.1,6.1,6.1,6.1,3.7,7.1,9.7,17.9,2.0,94.6,8.7,24257,1822,1822,1822,1822,1115,2138,2931,5402,594,28475,2617,22435,1822,1115,1023,793,2471,74.5,6.1,3.7,3.4,2.6,8.2
E07000207,ELMBRIDGE,61202,60975,98.4,80.5,78.2,15.7,15.7,0.0,0.1,0.1,1.2,0.0,99.2,0.0,60252,49283,47854,9584,9592,29,42,70,723,2,60703,0,12398,47854,29,13,28,653,20.3,78.2,0.0,0.0,0.0,1.1
E09000010,ENFIELD,133520,132354,97.0,88.0,86.9,3.6,86.3,0.0,0.1,0.8,2.2,0.0,97.3,0.0,129449,117511,116046,4866,115227,28,196,1041,2905,62,129939,0,13403,116046,28,168,845,1864,10.0,86.9,0.0,0.1,0.6,1.4
E07000072,EPPING FOREST,61299,61052,95.2,79.9,78.1,17.8,75.7,0.2,0.4,1.1,4.4,0.2,96.9,1.6,58335,48948,47900,10912,46411,99,273,647,2717,135,59417,964,10435,47900,99,174,374,2070,17.0,78.1,0.2,0.3,0.6,3.4
E07000208,EPSOM AND EWELL,33323,33258,99.4,88.9,88.7,67.8,67.9,0.0,0.2,0.2,0.4,0.1,99.5,0.0,33109,29622,29563,22604,22634,0,52,55,149,41,33168,0,3546,29563,0,52,3,94,10.6,88.7,0.0,0.2,0.0,0.3
E07000036,EREWASH,55949,55686,97.9,78.9,77.3,29.0,29.0,0.2,0.3,0.4,1.6,0.0,99.3,0.0,54787,44127,43275,16252,16252,130,174,219,899,9,55555,0,11512,43275,130,44,45,680,20.6,77.3,0.2,0.1,0.1,1.2
E07000041,EXETER,58654,58253,95.9,87.5,87.2,63.7,63.7,0.1,0.2,1.3,3.4,0.0,96.6,33.6,56274,51346,51141,37366,37366,33,108,786,1979,9,56683,19689,5133,51141,33,75,678,1193,8.8,87.2,0.1,0.1,1.2,2.0
S12000014,FALKIRK,73917,73866,97.0,85.9,85.7,10.7,85.6,0.1,0.4,0.9,2.9,0.1,98.8,0.0,71729,63507,63370,7892,63297,49,262,632,2137,110,73001,0,8359,63370,49,213,370,1505,11.3,85.7,0.1,0.3,0.5,2.0
E07000087,FAREHAM,52758,52633,98.1,85.8,82.8,3.9,4.0,0.1,0.1,0.3,1.6,0.0,99.4,0.0,51778,45286,43659,2054,2098,48,77,159,855,2,52424,0,8119,43659,48,29,82,696,15.4,82.8,0.1,0.1,0.2,1.3
E07000010,FENLAND,48348,48099,95.0,60.2,60.1,31.3,31.3,0.3,0.9,1.4,4.5,0.5,98.5,0.0,45943,29105,29067,15133,15133,149,419,656,2156,223,47604,1,16876,29067,149,270,237,1500,34.9,60.1,0.3,0.6,0.5,3.1
N09000006,FERMANAGH AND OMAGH,49984,49103,69.2,35.9,35.9,35.9,35.9,8.2,13.5,18.1,29.0,5.4,96.9,39.9,34606,17962,17962,17962,17962,4109,6755,9049,14497,2724,48442,19928,16644,17962,4109,2646,2294,5448,33.3,35.9,8.2,5.3,4.6,10.9
S12000047,FIFE,191939,190427,95.2,56.0,55.5,27.2,27.2,0.3,0.7,1.4,4.0,0.2,98.3,0.0,182768,107421,106568,52285,52285,514,1423,2666,7659,458,188706,0,76200,106568,514,909,1243,4993,39.7,55.5,0.3,0.5,0.6,2.6
W06000005,FLINTSHIRE,74694,74317,94.9,63.7,59.0,56.4,56.4,0.3,1.0,2.0,4.6,0.4,97.7,39.3,70880,47554,44072,42113,42113,237,753,1525,3437,292,72947,29323,26808,44072,237,516,772,1912,35.9,59.0,0.3,0.7,1.0,2.6
E07000112,FOLKESTONE AND HYTHE,54720,54420,93.8,58.1,57.9,26.4,26.4,0.4,1.0,2.1,5.7,0.3,97.8,12.6,51314,31777,31684,14451,14451,234,546,1168,3106,141,53508,6886,19630,31684,234,312,622,1938,35.9,57.9,0.4,0.6,1.1,3.5
E07000080,FOREST OF DEAN,41801,41499,82.3,32.9,31.0,29.8,29.8,0.6,2.8,6.8,17.0,1.7,89.3,0.3,34402,13744,12977,12477,12477,233,1172,2840,7097,719,37343,136,21425,12977,233,939,1668,4257,51.3,31.0,0.6,2.2,4.0,10.2
E07000119,FYLDE,36416,36143,93.8,51.4,42.5,15.8,15.8,0.1,0.3,0.8,5.5,0.0,98.1,19.8,34153,18734,15467,5737,5759,26,122,289,1990,6,35729,7193,18686,15467,26,96,167,1701,51.3,42.5,0.1,0.3,0.5,4.7
E08000037,GATESHEAD,101249,100659,95.5,71.6,70.1,6.1,6.2,0.1,0.3,1.0,3.9,0.0,97.2,0.0,96674,72501,70990,6223,6254,57,292,1000,3985,41,98403,1,25684,70990,57,235,708,2985,25.4,70.1,0.1,0.2,0.7,2.9
E07000173,GEDLING,55374,55256,98.7,88.8,87.8,44.2,44.2,0.1,0.2,0.3,1.1,0.1,99.6,0.5,54637,49187,48644,24474,24474,32,117,143,619,36,55179,269,5993,48644,32,85,26,476,10.8,87.8,0.1,0.2,0.0,0.9
S12000049,GLASGOW CITY,336398,334569,96.9,76.6,70.9,26.0,66.7,0.0,0.0,0.2,2.5,0.0,97.3,0.0,326086,257537,238423,87370,224236,34,127,703,8483,5,327373,0,87663,238423,34,93,576,7780,26.1,70.9,0.0,0.0,0.2,2.3
E07000081,GLOUCESTER,60419,60283,98.8,90.8,89.9,19.2,90.0,0.0,0.2,0.3,0.9,0.0,99.2,0.0,59716,54840,54324,11572,54349,1,127,190,567,0,59931,2,5392,54324,1,126,63,377,8.9,89.9,0.0,0.2,0.1,0.6
E07000088,GOSPORT,38965,38935,99.5,87.4,87.3,4.6,4.6,0.0,0.0,0.0,0.4,0.0,99.9,0.0,38771,34050,34027,1779,1779,1,9,14,164,0,38909,0,4744,34027,1,8,5,150,12.2,87.3,0.0,0.0,0.0,0.4
E07000109,GRAVESHAM,45524,45239,96.5,77.3,72.4,15.9,15.9,0.1,0.3,0.5,2.8,0.1,98.5,0.0,43944,35188,32943,7244,7244,25,131,217,1295,56,44828,0,11001,32943,25,106,86,1078,24.2,72.4,0.1,0.2,0.2,2.4
E07000145,GREAT YARMOUTH,49254,49039,97.2,56.2,56.2,12.2,12.2,0.0,0.1,0.4,2.4,0.1,99.2,0.0,47862,27696,27686,6030,6031,15,59,191,1177,59,48876,0,20176,27686,15,44,132,986,41.0,56.2,0.0,0.1,0.3,2.0
E09000011,GREENWICH,125935,125319,98.0,82.5,79.9,23.6,78.4,0.0,0.1,0.4,1.5,0.0,98.2,0.0,123472,103870,100587,29772,98743,0,145,507,1847,0,123650,2,22885,100587,0,145,362,1340,18.2,79.9,0.0,0.1,0.3,1.1
E07000209,GUILDFORD,59342,58652,95.1,67.6,64.4,3.6,3.6,0.0,0.2,0.7,3.7,0.2,98.0,0.0,56442,40103,38213,2154,2155,26,127,430,2210,131,58172,0,18229,38213,26,101,303,1780,30.7,64.4,0.0,0.2,0.5,3.0
W06000002,GWYNEDD,68105,67426,87.5,19.6,18.1,17.1,17.1,1.3,3.2,5.6,11.5,2.1,93.2,17.5,59594,13350,12302,11656,11656,871,2201,3826,7832,1402,63453,11924,47292,12302,871,1330,1625,4006,69.4,18.1,1.3,2.0,2.4,5.9
E09000012,HACKNEY,126561,125482,97.0,77.8,73.3,29.3,71.2,0.0,0.0,0.2,2.2,0.2,97.0,0.0,122717,98483,92724,37122,90051,0,0,223,2765,238,122803,0,29993,92724,0,0,223,2542,23.7,73.3,0.0,0.0,0.2,2.0
E06000006,HALTON,62608,61768,96.8,67.7,67.0,4.8,5.5,0.0,0.1,0.3,1.9,0.0,98.2,0.0,60596,42360,41919,2991,3444,17,85,196,1172,0,61496,0,18677,41919,17,68,111,976,29.8,67.0,0.0,0.1,0.2,1.6
E07000164,HAMBLETON,45097,44750,89.9,9.2,8.4,8.2,8.2,1.3,3.0,4.7,9.4,1.1,97.3,38.9,40527,4127,3807,3681,3682,601,1371,2131,4223,499,43879,17545,36720,3807,601,770,760,2092,81.4,8.4,1.3,1.7,1.7,4.6
E09000013,HAMMERSMITH AND FULHAM,93679,92198,94.3,75.2,64.5,37.5,56.1,0.0,0.1,0.3,4.1,0.2,94.3,0.0,88335,70451,60378,35108,52523,2,75,259,3863,164,88326,0,27957,60378,2,73,184,3604,29.8,64.5,0.0,0.1,0.2,3.8
E07000131,HARBOROUGH,43862,43620,95.0,45.6,40.4,19.0,36.2,0.3,0.7,1.4,4.5,0.5,98.4,0.0,41655,20015,17715,8322,15892,136,299,612,1965,200,43150,0,23940,17715,136,163,313,1353,54.6,40.4,0.3,0.4,0.7,3.1
E09000014,HARINGEY,110408,110214,98.4,85.2,83.8,4.9,82.5,0.0,0.0,0.3,1.5,0.0,98.5,0.0,108606,94025,92499,5357,91112,0,16,293,1608,0,108715,0,16107,92499,0,16,277,1315,14.6,83.8,0.0,0.0,0.3,1.2
E07000073,HARLOW,41596,41428,97.2,91.8,90.1,8.5,8.5,0.0,0.1,1.0,2.4,0.0,97.4,0.0,40432,38204,37463,3518,3518,2,26,429,996,8,40495,1,2969,37463,2,24,403,567,7.1,90.1,0.0,0.1,1.0,1.4
E07000165,HARROGATE,78878,78324,92.5,58.9,57.0,29.4,29.5,0.7,1.6,2.4,6.8,0.7,97.4,13.3,72937,46439,44972,23227,23266,550,1239,1882,5387,539,76836,10512,27965,44972,550,689,643,3505,35.5,57.0,0.7,0.9,0.8,4.4
E09000015,HARROW,99769,99434,97.6,81.2,81.0,15.7,80.9,0.0,0.1,0.5,2.0,0.0,97.7,0.0,97392,80996,80770,15687,80685,15,51,451,2042,9,97508,0,16622,80770,15,36,400,1591,16.7,81.0,0.0,0.0,0.4,1.6
E07000089,HART,43816,43515,95.0,62.6,62.5,9.4,41.9,0.1,0.5,0.8,4.3,0.1,98.5,0.0,41637,27438,27405,4106,18373,31,221,366,1878,65,43150,1,14232,27405,31,190,145,1512,32.5,62.5,0.1,0.4,0.3,3.5
E06000001,HARTLEPOOL,47613,47138,95.7,88.1,88.0,6.0,6.0,0.3,0.5,1.2,3.3,0.1,96.3,0.7,45552,41929,41891,2849,2849,141,259,560,1586,51,45831,312,3661,41891,141,118,301,1026,7.7,88.0,0.3,0.2,0.6,2.2
E07000062,HASTINGS,46192,45914,98.2,4.7,4.7,4.7,4.7,0.0,0.0,0.1,1.2,0.0,99.3,0.0,45379,2153,2153,2153,2153,0,6,28,535,1,45867,0,43226,2153,0,6,22,507,93.6,4.7,0.0,0.0,0.0,1.1
E07000090,HAVANT,58152,57887,98.8,85.9,85.8,1.5,1.5,0.0,0.0,0.1,0.8,0.0,99.2,0.0,57430,49941,49911,889,889,1,27,72,457,4,57683,0,7519,49911,1,26,45,385,12.9,85.8,0.0,0.0,0.1,0.7
E09000016,HAVERING,113671,112926,96.5,84.9,82.8,5.0,81.5,0.0,0.1,0.5,2.8,0.3,97.4,0.0,109694,96526,94137,5704,92641,53,168,580,3232,323,110708,0,15557,94137,53,115,412,2652,13.7,82.8,0.0,0.1,0.4,2.3
E06000019,"HEREFORDSHIRE, COUNTY OF",91050,90267,88.7,31.5,27.3,24.5,24.5,0.9,2.5,4.4,10.4,1.8,95.3,2.8,80786,28691,24882,22296,22296,837,2252,4002,9481,1629,86789,2584,55904,24882,837,1415,1750,5479,61.4,27.3,0.9,1.6,1.9,6.0
E07000098,HERTSMERE,47003,46763,97.5,83.3,80.9,9.3,9.3,0.0,0.2,0.4,2.0,0.0,98.5,0.0,45844,39152,38031,4370,4370,6,90,175,919,2,46303,0,7813,38031,6,84,85,744,16.6,80.9,0.0,0.2,0.2,1.6
E07000037,HIGH PEAK,46313,46002,92.6,11.3,7.8,4.5,4.5,0.4,0.7,1.3,6.7,0.5,98.4,0.0,42887,5229,3628,2076,2076,188,346,596,3115,214,45589,0,39259,3628,188,158,250,2519,84.8,7.8,0.4,0.3,0.5,5.4
S12000017,HIGHLAND,115695,113086,81.9,22.5,22.5,22.5,22.5,2.3,4.6,7.7,15.9,3.9,93.2,4.6,94740,25994,25994,25994,25994,2629,5300,8916,18346,4461,107847,5378,68746,25994,2629,2671,3616,9430,59.4,22.5,2.3,2.3,3.1,8.2
E09000017,HILLINGDON,121612,120154,95.9,86.6,85.5,25.5,84.8,0.0,0.2,0.7,2.9,0.0,96.1,0.0,116576,105372,104002,30971,103079,49,199,894,3578,26,116847,0,12574,104002,49,150,695,2684,10.3,85.5,0.0,0.1,0.6,2.2
E07000132,HINCKLEY AND BOSWORTH,54635,54247,96.6,64.7,61.7,9.2,9.3,0.1,0.8,1.0,2.7,0.2,98.4,0.0,52776,35337,33724,5052,5054,31,437,556,1471,109,53741,0,19052,33724,31,406,119,915,34.9,61.7,0.1,0.7,0.2,1.7
E07000227,HORSHAM,67489,67006,92.8,40.5,35.6,31.6,31.6,0.4,1.0,1.8,6.4,0.7,98.3,0.0,62660,27311,24011,21343,21343,239,691,1219,4346,487,66331,0,38649,24011,239,452,528,3127,57.3,35.6,0.4,0.7,0.8,4.6
E09000018,HOUNSLOW,101655,100757,96.5,85.1,84.8,11.3,84.7,0.0,0.1,0.7,2.7,0.4,96.6,0.0,98047,86523,86198,11519,86148,0,131,728,2710,372,98153,0,11849,86198,0,131,597,1982,11.7,84.8,0.0,0.1,0.6,1.9
E07000011,HUNTINGDONSHIRE,84111,83306,96.1,59.2,55.2,10.7,10.7,0.3,0.6,1.1,2.9,0.4,98.4,0.0,80836,49835,46413,8984,8984,225,528,912,2470,318,82765,7,34423,46413,225,303,384,1558,40.9,55.2,0.3,0.4,0.5,1.9
E07000120,HYNDBURN,41430,40827,96.9,76.7,72.6,17.4,17.5,0.0,0.1,0.2,1.6,0.0,98.3,84.8,40154,31780,30083,7220,7253,18,40,82,673,1,40746,35147,10071,30083,18,22,42,591,24.3,72.6,0.0,0.1,0.1,1.4
S12000018,INVERCLYDE,41970,41917,96.6,73.4,73.1,10.3,73.1,0.1,0.4,0.7,3.3,0.1,98.4,0.0,40543,30786,30673,4314,30673,42,148,294,1374,61,41310,0,9870,30673,42,106,146,1080,23.5,73.1,0.1,0.3,0.3,2.6
E07000202,IPSWICH,65370,65137,98.2,88.5,85.9,27.7,27.7,0.0,0.1,0.4,1.5,0.0,98.4,0.0,64166,57877,56161,18078,18079,0,40,238,971,7,64327,0,8005,56161,0,40,198,733,12.2,85.9,0.0,0.1,0.3,1.1
W06000001,ISLE OF ANGLESEY,37531,36990,88.9,16.9,16.9,16.9,16.9,0.8,2.1,3.6,9.6,1.5,95.2,25.2,33375,6359,6333,6359,6359,306,776,1353,3615,560,35722,9447,27042,6333,306,470,577,2262,72.1,16.9,0.8,1.3,1.5,6.0
E06000046,ISLE OF WIGHT,78495,77985,93.0,35.6,35.6,35.6,35.6,0.3,0.7,1.3,6.3,0.3,99.1,0.0,73029,27940,27940,27940,27940,203,530,998,4956,234,77790,0,45089,27940,203,327,468,3958,57.4,35.6,0.3,0.4,0.6,5.0
E06000053,ISLES OF SCILLY,1683,1661,96.4,1.6,1.6,1.6,1.6,0.0,0.0,0.1,2.3,0.1,98.7,0.0,1622,27,27,27,27,0,0,2,39,1,1661,0,1595,27,0,0,2,37,94.8,1.6,0.0,0.0,0.1,2.2
E09000019,ISLINGTON,119037,118433,95.5,84.4,83.7,30.6,83.7,0.0,0.0,0.1,4.0,0.0,95.5,0.0,113655,100465,99663,36367,99647,0,0,69,4778,1,113664,0,13992,99663,0,0,69,4709,11.8,83.7,0.0,0.0,0.1,4.0
E09000020,KENSINGTON AND CHELSEA,98297,98048,96.9,89.7,86.4,35.4,84.1,0.0,0.0,0.1,2.9,0.0,96.9,0.0,95221,88149,84918,34792,82674,0,0,51,2827,13,95220,0,10303,84918,0,0,51,2776,10.5,86.4,0.0,0.0,0.1,2.8
E07000146,"KING'S LYNN AND WEST NORFOLK",78833,77993,91.6,19.6,15.4,12.2,12.2,0.4,1.1,2.0,7.4,0.8,97.6,0.0,72195,15478,12171,9647,9647,329,841,1611,5798,669,76945,8,60024,12171,329,512,770,4187,76.1,15.4,0.4,0.6,1.0,5.3
E06000010,"KINGSTON UPON HULL, CITY OF",129189,127241,98.5,97.6,97.6,97.6,97.6,0.0,0.0,0.0,0.0,0.0,98.5,42.6,127195,126051,126051,126051,126051,1,2,26,46,2,127195,55061,1144,126051,1,1,24,20,0.9,97.6,0.0,0.0,0.0,0.0
E09000021,KINGSTON UPON THAMES,70730,70463,97.9,90.5,87.0,4.0,84.9,0.0,0.0,0.1,1.8,0.0,98.2,0.0,69215,64011,61551,2861,60085,0,2,78,1248,4,69422,0,7664,61551,0,2,76,1170,10.8,87.0,0.0,0.0,0.1,1.7
E08000034,KIRKLEES,197914,197146,96.9,75.5,75.4,38.0,38.3,0.0,0.2,0.5,2.7,0.0,98.7,0.0,191838,149410,149215,75161,75725,78,325,908,5308,32,195383,0,42623,149215,78,247,583,4400,21.5,75.4,0.0,0.1,0.3,2.2
E08000011,KNOWSLEY,73441,73211,98.4,80.6,80.3,23.0,80.1,0.0,0.2,0.2,1.3,0.0,99.3,6.5,72257,59170,58945,16926,58838,15,116,176,954,28,72892,4764,13312,58945,15,101,60,778,18.1,80.3,0.0,0.1,0.1,1.1
E09000022,LAMBETH,154473,153467,96.5,79.5,75.5,29.9,72.9,0.0,0.0,0.0,2.9,0.0,96.6,0.0,149025,122794,116631,46189,112645,0,0,6,4442,2,149262,0,32394,116631,0,0,6,4436,21.0,75.5,0.0,0.0,0.0,2.9
E07000121,LANCASTER,68102,67782,97.6,63.7,54.6,17.8,17.8,0.2,0.3,0.5,2.0,0.1,99.2,2.0,66453,43356,37171,12090,12091,145,208,350,1329,55,67574,1383,29282,37171,145,63,142,979,43.0,54.6,0.2,0.1,0.2,1.4
E08000035,LEEDS,378522,377010,96.6,86.6,84.9,60.7,84.0,0.0,0.2,0.5,3.0,0.1,97.3,12.7,365699,327751,321460,229819,318008,104,859,1794,11311,261,368489,47923,44239,321460,104,755,935,9517,11.7,84.9,0.0,0.2,0.2,2.5
E06000016,LEICESTER,145627,145165,98.9,92.5,91.0,24.1,24.1,0.0,0.0,0.1,0.8,0.0,99.0,0.0,143960,134654,132545,35066,35066,0,7,98,1205,4,144197,0,11415,132545,0,7,91,1107,7.8,91.0,0.0,0.0,0.1,0.8
E07000063,LEWES,47769,47541,96.7,29.6,29.6,29.5,29.5,0.1,0.3,0.5,2.8,0.2,99.3,0.0,46200,14141,14134,14110,14110,36,120,234,1341,97,47432,0,32066,14134,36,84,114,1107,67.1,29.6,0.1,0.2,0.2,2.3
E09000023,LEWISHAM,139839,137440,94.6,68.6,67.1,20.5,66.3,0.0,0.0,0.2,3.6,0.0,94.9,0.0,132346,95894,93787,28664,92646,0,0,285,5094,0,132663,0,38559,93787,0,0,285,4809,27.6,67.1,0.0,0.0,0.2,3.4
E07000194,LICHFIELD,49272,49033,95.6,71.3,67.9,25.3,65.3,0.3,0.6,1.2,3.9,0.1,99.2,0.0,47128,35141,33479,12480,32188,130,279,585,1905,62,48858,0,13649,33479,130,149,306,1320,27.7,67.9,0.3,0.3,0.6,2.7
E07000138,LINCOLN,48360,48259,98.0,82.5,81.6,2.9,2.9,0.0,0.1,0.5,1.8,0.0,98.3,78.7,47395,39897,39463,1412,1412,14,33,246,864,0,47526,38063,7932,39463,14,19,213,618,16.4,81.6,0.0,0.0,0.4,1.3
N09000007,LISBURN AND CASTLEREAGH,60265,59685,92.8,78.5,78.5,68.7,78.5,0.3,1.3,2.2,6.2,0.9,98.3,0.0,55932,47292,47291,41403,47291,177,783,1308,3753,529,59261,0,8641,47291,177,606,525,2445,14.3,78.5,0.3,1.0,0.9,4.1
E08000012,LIVERPOOL,235514,234314,94.9,82.6,80.2,38.3,78.6,0.0,0.0,0.4,4.6,0.0,95.2,0.0,223444,194609,188901,90100,185019,4,48,832,10870,7,224232,0,34543,188901,4,44,784,10038,14.7,80.2,0.0,0.0,0.3,4.3
E06000032,LUTON,86334,85983,98.9,93.5,91.3,2.1,2.1,0.0,0.2,0.3,0.7,0.0,99.0,0.0,85360,80702,78863,1774,1774,9,206,257,623,0,85475,0,6497,78863,9,197,51,366,7.5,91.3,0.0,0.2,0.1,0.4
E07000110,MAIDSTONE,79436,78772,92.1,72.2,67.9,27.8,27.8,0.5,1.3,2.1,7.0,0.5,97.3,29.0,73174,57342,53939,22083,22083,377,1001,1655,5598,433,77327,23053,19235,53939,377,624,654,3943,24.2,67.9,0.5,0.8,0.8,5.0
E07000074,MALDON,30310,30154,94.6,37.8,37.8,37.8,37.8,0.3,0.9,1.8,4.9,0.5,98.7,6.7,28669,11463,11463,11463,11463,95,280,560,1485,150,29924,2025,17206,11463,95,185,280,925,56.8,37.8,0.3,0.6,0.9,3.1
E07000235,MALVERN HILLS,38663,38428,90.2,26.0,19.2,15.1,15.1,0.5,1.8,3.4,9.2,1.0,97.8,5.4,34869,10058,7441,5829,5829,179,696,1316,3559,381,37799,2078,27428,7441,179,517,620,2243,70.9,19.2,0.5,1.3,1.6,5.8
E08000003,MANCHESTER,249498,244154,93.0,76.4,73.1,30.9,70.5,0.0,0.1,0.9,4.9,0.0,93.4,0.0,231946,190532,182455,77025,175920,31,286,2224,12208,0,232920,53,49491,182455,31,255,1938,9984,19.8,73.1,0.0,0.1,0.8,4.0
E07000174,MANSFIELD,53280,53105,98.7,88.5,85.9,9.7,9.7,0.0,0.1,0.2,1.0,0.0,99.3,0.0,52573,47158,45748,5153,5153,5,35,99,532,16,52904,0,6825,45748,5,30,64,433,12.8,85.9,0.0,0.1,0.1,0.8
E06000035,MEDWAY,122461,122001,97.2,84.4,81.4,8.8,8.8,0.0,0.3,0.7,2.5,0.1,98.6,2.8,118991,103405,99636,10821,10821,37,327,876,3010,119,120707,3465,19355,99636,37,290,549,2134,15.8,81.4,0.0,0.2,0.4,1.7
E07000133,MELTON,24822,24675,93.1,46.8,46.4,2.6,2.6,0.8,1.9,3.1,6.3,1.3,96.8,5.7,23107,11619,11507,641,641,199,484,760,1568,318,24028,1420,11600,11507,199,285,276,808,46.7,46.4,0.8,1.1,1.1,3.3
E07000187,MENDIP,55925,55684,87.5,51.0,46.1,25.1,25.1,0.5,1.9,4.7,12.1,0.7,94.7,1.6,48926,28515,25786,14054,14054,261,1059,2639,6758,387,52951,910,23140,25786,261,798,1580,4119,41.4,46.1,0.5,1.4,2.8,7.4
W06000024,MERTHYR TYDFIL,28568,28479,98.5,44.3,44.3,44.3,44.3,0.1,0.2,0.3,1.2,0.0,99.5,10.1,28129,12664,12664,12659,12664,20,47,97,350,5,28417,2887,15465,12664,20,27,50,253,54.1,44.3,0.1,0.1,0.2,0.9
E09000024,MERTON,90122,89948,98.6,89.3,87.6,37.0,87.6,0.0,0.0,0.2,1.2,0.0,98.6,0.0,88831,80521,78989,33338,78980,1,32,153,1117,1,88868,0,9842,78989,1,31,121,964,10.9,87.6,0.0,0.0,0.1,1.1
N09000008,MID AND EAST ANTRIM,61724,61042,89.5,72.7,72.7,72.6,72.7,1.9,3.3,4.5,9.4,1.7,97.8,0.0,55265,44843,44843,44841,44843,1157,2058,2800,5777,1060,60379,0,10422,44843,1157,901,742,2977,16.9,72.7,1.9,1.5,1.2,4.8
E07000042,MID DEVON,37811,37433,78.2,10.9,10.9,10.9,10.9,1.7,5.7,10.1,20.8,3.0,91.8,11.5,29556,4105,4105,4103,4103,647,2161,3822,7877,1130,34721,4346,25451,4105,647,1514,1661,4055,67.3,10.9,1.7,4.0,4.4,10.7
E07000203,MID SUFFOLK,48662,48113,91.8,18.4,17.3,16.7,16.7,0.3,0.8,1.7,7.0,0.9,97.9,0.1,44690,8966,8395,8112,8112,169,392,842,3423,437,47632,31,36295,8395,169,223,450,2581,74.6,17.3,0.3,0.5,0.9,5.3
E07000228,MID SUSSEX,68855,68446,95.4,39.5,38.3,37.4,37.4,0.0,0.2,0.7,4.0,0.4,98.9,0.0,65697,27219,26388,25763,25763,30,167,511,2749,252,68100,0,39309,26388,30,137,344,2238,57.1,38.3,0.0,0.2,0.5,3.3
N09000009,MID ULSTER,55387,54572,80.6,51.9,51.9,51.9,51.9,3.4,6.4,9.2,17.9,5.6,97.5,4.5,44663,28734,28733,28733,28733,1904,3536,5117,9909,3085,53993,2487,15930,28733,1904,1632,1581,4792,28.8,51.9,3.4,2.9,2.9,8.7
E06000002,MIDDLESBROUGH,68389,68113,97.3,92.4,92.1,6.5,6.5,0.1,0.4,0.9,2.3,0.1,97.5,2.1,66525,63186,62976,4417,4417,69,301,592,1588,60,66705,1418,3549,62976,69,232,291,996,5.2,92.1,0.1,0.3,0.4,1.5
S12000019,MIDLOTHIAN,42787,42347,93.6,58.6,58.5,58.5,58.6,0.7,1.3,2.4,5.3,0.4,97.8,4.7,40063,25054,25041,25039,25053,289,570,1012,2284,179,41841,2012,15022,25041,289,281,442,1272,35.1,58.5,0.7,0.7,1.0,3.0
E06000042,MILTON KEYNES,122925,122438,98.0,89.4,88.2,87.4,87.4,0.1,0.3,0.9,1.6,0.2,98.7,0.0,120454,109882,108479,107428,107439,71,354,1139,1984,201,121266,1,11975,108479,71,283,785,845,9.7,88.2,0.1,0.2,0.6,0.7
E07000210,MOLE VALLEY,40052,39919,95.5,61.9,61.9,11.0,11.0,0.0,0.3,0.8,4.2,0.4,99.2,0.0,38246,24803,24789,4415,4415,18,108,315,1673,173,39712,0,13457,24789,18,90,207,1358,33.6,61.9,0.0,0.2,0.5,3.4
W06000021,MONMOUTHSHIRE,45537,45145,86.3,27.2,18.1,12.3,12.3,1.4,3.4,6.1,12.8,2.5,95.4,0.2,39317,12373,8257,5591,5591,629,1544,2796,5828,1133,43457,80,31060,8257,629,915,1252,3032,68.2,18.1,1.4,2.0,2.7,6.7
S12000020,MORAY,49558,49109,84.5,22.2,22.2,22.2,22.2,1.7,4.5,7.1,14.6,2.9,95.3,34.2,41852,10991,10991,10991,10991,849,2229,3495,7257,1456,47216,16964,30861,10991,849,1380,1266,3762,62.3,22.2,1.7,2.8,2.6,7.6
S12000013,NA H-EILEANAN SIAR,16684,15209,75.7,4.5,4.5,4.5,4.5,2.5,3.9,5.1,15.5,6.1,87.9,0.0,12626,750,750,750,750,425,649,853,2583,1016,14673,0,11876,750,425,224,204,1730,71.2,4.5,2.5,1.3,1.2,10.4
W06000012,NEATH PORT TALBOT,68981,68867,96.9,59.3,59.3,4.4,30.0,0.1,0.2,0.4,2.9,0.1,99.1,32.5,66855,40891,40883,3027,20662,53,138,273,2012,69,68366,22432,25972,40883,53,85,135,1739,37.7,59.3,0.1,0.1,0.2,2.5
E07000091,NEW FOREST,87651,87153,93.1,27.4,24.7,11.3,11.4,0.4,0.7,1.4,6.4,0.7,98.7,0.1,81586,23982,21650,9923,9965,376,643,1193,5567,584,86533,83,59936,21650,376,267,550,4374,68.4,24.7,0.4,0.3,0.6,5.0
E07000175,NEWARK AND SHERWOOD,59993,59468,95.3,56.2,55.8,16.5,16.5,0.3,0.9,1.4,3.9,0.2,98.2,30.6,57154,33699,33503,9919,9920,154,538,859,2314,129,58896,18362,23651,33503,154,384,321,1455,39.4,55.8,0.3,0.6,0.5,2.4
E08000021,NEWCASTLE UPON TYNE,139408,138552,96.2,76.6,73.4,35.9,35.9,0.0,0.1,0.2,3.2,0.0,96.9,0.0,134079,106825,102394,50110,50114,62,150,319,4473,58,135058,55,31685,102394,62,88,169,4154,22.7,73.4,0.0,0.1,0.1,3.0
E07000195,NEWCASTLE-UNDER-LYME,61337,60360,95.0,66.9,65.8,12.5,12.5,0.0,0.4,0.8,3.4,0.1,97.6,2.1,58293,41022,40387,7641,7641,24,217,465,2067,79,59865,1264,17906,40387,24,193,248,1602,29.2,65.8,0.0,0.3,0.4,2.6
E09000025,NEWHAM,128808,128336,98.2,90.2,86.8,58.7,83.3,0.0,0.1,0.5,1.5,0.0,98.2,0.0,126449,116214,111770,75620,107275,12,151,701,1887,22,126466,0,14679,111770,12,139,550,1186,11.4,86.8,0.0,0.1,0.4,0.9
W06000022,NEWPORT,72676,72432,97.3,73.7,70.7,9.6,9.6,0.1,0.3,0.7,2.4,0.1,98.1,34.0,70687,53528,51369,6953,6953,63,229,497,1745,109,71306,24686,19318,51369,63,166,268,1248,26.6,70.7,0.1,0.2,0.4,1.7
N09000010,"NEWRY, MOURNE AND DOWN",70631,69188,88.1,69.5,69.4,69.5,69.5,1.6,3.3,4.7,9.9,2.9,97.4,3.3,62201,49113,49019,49112,49113,1111,2320,3322,6987,2050,68811,2307,13182,49019,1111,1209,1002,3665,18.7,69.4,1.6,1.7,1.4,5.2
S12000021,NORTH AYRSHIRE,72396,72027,93.8,31.9,31.9,15.1,15.1,0.4,0.9,1.6,5.6,0.3,98.6,0.0,67941,23106,23104,10928,10928,311,624,1189,4086,219,71369,0,44837,23104,311,313,565,2897,61.9,31.9,0.4,0.4,0.8,4.0
E07000043,NORTH DEVON,51857,51373,86.7,27.3,27.3,27.3,27.3,1.5,3.4,6.2,12.4,1.6,93.7,52.6,44948,14175,14175,14175,14175,774,1756,3213,6425,841,48603,27286,30773,14175,774,982,1457,3212,59.3,27.3,1.5,1.9,2.8,6.2
E07000038,NORTH EAST DERBYSHIRE,49010,48762,93.3,35.9,33.9,32.4,32.4,0.3,0.7,1.2,6.2,0.1,98.8,0.0,45715,17584,16612,15856,15856,158,364,592,3047,72,48434,0,29103,16612,158,206,228,2455,59.4,33.9,0.3,0.4,0.5,5.0
E06000012,NORTH EAST LINCOLNSHIRE,74367,74205,96.7,88.5,88.1,1.6,1.6,0.1,0.8,1.3,3.0,0.2,97.5,27.8,71948,65841,65500,1209,1209,61,623,948,2257,140,72537,20664,6448,65500,61,562,325,1309,8.7,88.1,0.1,0.8,0.4,1.8
E07000099,NORTH HERTFORDSHIRE,61428,61146,96.3,74.6,73.4,5.9,5.9,0.1,0.3,0.8,3.2,0.2,98.2,0.1,59167,45833,45091,3635,3635,39,189,464,1979,132,60296,48,14076,45091,39,150,275,1515,22.9,73.4,0.1,0.2,0.4,2.5
E07000139,NORTH KESTEVEN,55082,54730,94.0,43.8,42.5,14.4,14.4,0.7,1.3,2.2,5.4,0.6,98.2,32.1,51770,24126,23435,7907,7907,379,740,1193,2960,323,54077,17682,28335,23435,379,361,453,1767,51.4,42.5,0.7,0.7,0.8,3.2
S12000050,NORTH LANARKSHIRE,165620,165231,97.8,79.3,78.3,14.4,78.0,0.1,0.3,0.6,1.9,0.1,99.0,0.0,162007,131391,129763,23898,129178,86,471,961,3224,206,164006,0,32244,129763,86,385,490,2263,19.5,78.3,0.1,0.2,0.3,1.4
E06000013,NORTH LINCOLNSHIRE,80844,80313,93.5,49.5,49.4,11.0,49.4,0.6,1.2,1.8,5.9,0.4,97.1,61.6,75567,39997,39973,8876,39949,472,975,1466,4746,299,78506,49785,35594,39973,472,503,491,3280,44.0,49.4,0.6,0.6,0.6,4.1
E07000147,NORTH NORFOLK,60977,60518,90.6,6.3,6.3,6.3,6.3,0.5,1.4,2.5,8.7,1.9,97.1,0.0,55228,3833,3833,3826,3826,322,877,1549,5290,1156,59238,23,51395,3833,322,555,672,3741,84.3,6.3,0.5,0.9,1.1,6.1
E06000061,NORTH NORTHAMPTONSHIRE,163436,162689,97.9,74.7,73.8,21.6,73.8,0.1,0.3,0.5,1.6,0.2,98.7,0.0,160031,122116,120637,35256,120605,127,529,868,2658,370,161377,28,39394,120637,127,402,339,1790,24.1,73.8,0.1,0.2,0.2,1.1
E06000024,NORTH SOMERSET,103481,102635,92.9,60.6,54.2,32.3,32.3,0.1,0.5,1.3,6.3,0.3,96.3,0.0,96154,62661,56127,33424,33457,153,567,1301,6481,352,99671,0,40027,56127,153,414,734,5180,38.7,54.2,0.1,0.4,0.7,5.0
E08000022,NORTH TYNESIDE,102795,102595,99.0,82.8,80.2,37.0,37.0,0.0,0.1,0.3,0.8,0.0,99.4,0.0,101742,85085,82457,38049,38050,19,78,281,853,22,102155,1,19285,82457,19,59,203,572,18.8,80.2,0.0,0.1,0.2,0.6
E07000218,NORTH WARWICKSHIRE,30686,30525,96.1,43.5,41.3,27.2,40.1,0.3,0.9,1.3,3.4,0.1,98.9,0.0,29482,13359,12687,8340,12314,85,268,393,1043,40,30363,0,16795,12687,85,183,125,650,54.7,41.3,0.3,0.6,0.4,2.1
E07000134,NORTH WEST LEICESTERSHIRE,49148,48960,96.9,70.6,68.8,7.6,7.6,0.1,0.6,1.0,2.8,0.2,99.0,0.0,47606,34702,33799,3752,3752,71,307,508,1354,104,48653,0,13807,33799,71,236,201,846,28.1,68.8,0.1,0.5,0.4,1.7
E06000057,NORTHUMBERLAND,159750,159054,92.8,17.3,12.9,10.2,10.2,0.9,1.6,2.4,6.8,0.8,98.4,2.6,148231,27673,20635,16316,16317,1369,2622,3870,10823,1311,157256,4179,127596,20635,1369,1253,1248,6953,79.9,12.9,0.9,0.8,0.8,4.4
E07000148,NORWICH,57813,57575,98.3,86.4,83.8,19.6,19.6,0.0,0.0,0.4,1.3,0.0,98.6,0.0,56812,49927,48473,11333,11333,0,6,260,763,2,56999,0,8339,48473,0,6,254,503,14.4,83.8,0.0,0.0,0.4,0.9
E06000018,NOTTINGHAM,144586,144080,98.0,92.5,90.8,32.8,32.8,0.0,0.1,0.2,1.6,0.0,98.1,0.0,141702,133706,131263,47394,47394,7,75,348,2378,4,141890,0,10439,131263,7,68,273,2030,7.2,90.8,0.0,0.0,0.2,1.4
E07000219,NUNEATON AND BEDWORTH,60891,60676,98.7,84.0,83.6,13.5,83.8,0.0,0.2,0.2,1.0,0.0,99.3,0.0,60092,51135,50900,8207,51000,13,105,132,584,8,60462,0,9192,50900,13,92,27,452,15.1,83.6,0.0,0.2,0.0,0.7
E07000135,OADBY AND WIGSTON,26102,25559,96.6,77.3,74.2,2.0,2.0,0.0,0.0,0.1,1.3,0.0,97.2,0.0,25224,20171,19379,522,522,1,4,20,335,0,25380,0,5845,19379,1,3,16,315,22.4,74.2,0.0,0.0,0.1,1.2
E08000004,OLDHAM,98698,98439,98.2,80.7,80.4,21.3,21.4,0.1,0.1,0.3,1.6,0.0,99.5,0.0,96878,79614,79322,21044,21105,56,130,279,1561,1,98224,0,17556,79322,56,74,149,1282,17.8,80.4,0.1,0.1,0.2,1.3
S12000023,ORKNEY ISLANDS,12808,12222,64.3,1.1,1.1,1.1,1.1,3.9,9.1,20.1,31.2,8.6,76.5,0.0,8230,145,145,145,145,504,1166,2569,3992,1106,9800,0,8085,145,504,662,1403,1423,63.1,1.1,3.9,5.2,11.0,11.1
E07000178,OXFORD,66065,65520,97.2,83.9,78.1,1.5,1.5,0.0,0.0,0.4,1.9,0.0,97.4,0.0,64244,55453,51587,975,975,0,31,262,1276,2,64345,0,12657,51587,0,31,231,1014,19.2,78.1,0.0,0.0,0.3,1.5
W06000009,PEMBROKESHIRE,66113,65831,88.0,8.2,8.2,8.2,8.2,1.7,3.8,6.3,11.6,2.2,94.9,0.7,58149,5415,5415,5410,5415,1151,2520,4198,7682,1466,62744,439,52734,5415,1151,1369,1678,3484,79.8,8.2,1.7,2.1,2.5,5.3
E07000122,PENDLE,44207,43816,95.5,57.1,56.8,6.2,56.3,0.4,0.9,1.2,3.6,0.2,98.2,53.0,42216,25253,25090,2752,24907,169,385,545,1600,93,43421,23422,17126,25090,169,216,160,1055,38.7,56.8,0.4,0.5,0.4,2.4
S12000048,PERTH AND KINROSS,79353,78620,85.3,37.1,36.2,7.0,7.0,1.7,4.1,7.1,13.8,2.1,95.1,0.0,67659,29457,28746,5544,5544,1314,3270,5638,10961,1670,75432,1,38913,28746,1314,1956,2368,5323,49.0,36.2,1.7,2.5,3.0,6.7
E06000031,PETERBOROUGH,92835,92579,98.6,88.5,88.0,80.9,80.9,0.1,0.3,0.5,1.1,0.1,99.4,0.0,91537,82118,81733,75089,75089,70,293,446,1042,86,92278,0,9804,81733,70,223,153,596,10.6,88.0,0.1,0.2,0.2,0.6
E06000026,PLYMOUTH,124496,123447,96.7,88.1,86.7,4.4,4.4,0.0,0.2,0.9,2.5,0.0,97.2,26.8,120395,109698,107981,5535,5536,4,228,1098,3052,19,120977,33394,12414,107981,4,224,870,1954,10.0,86.7,0.0,0.2,0.7,1.6
E06000044,PORTSMOUTH,95681,95422,97.2,94.3,91.9,24.0,24.0,0.0,0.1,0.3,2.5,0.0,97.3,0.0,93009,90208,87952,22934,22934,1,105,299,2413,2,93124,0,5057,87952,1,104,194,2114,5.3,91.9,0.0,0.1,0.2,2.2
W06000023,POWYS,69648,68335,78.5,17.9,17.9,17.9,17.9,3.4,6.9,11.1,19.6,5.0,88.2,5.8,54705,12454,12453,12451,12453,2340,4796,7726,13630,3476,61408,4053,42252,12453,2340,2456,2930,5904,60.7,17.9,3.4,3.5,4.2,8.5
E07000123,PRESTON,68162,67860,97.4,71.9,69.7,7.2,7.2,0.0,0.1,0.4,2.2,0.0,98.6,62.7,66369,48995,47520,4914,4914,26,55,245,1491,21,67219,42711,18849,47520,26,29,190,1246,27.7,69.7,0.0,0.0,0.3,1.8
E06000038,READING,75898,75177,97.4,88.6,85.0,16.9,82.7,0.0,0.1,0.2,1.6,0.0,97.6,0.0,73938,67240,64546,12808,62791,9,105,188,1239,25,74058,0,9392,64546,9,96,83,1051,12.4,85.0,0.0,0.1,0.1,1.4
E09000026,REDBRIDGE,111550,111013,97.9,86.9,86.0,34.2,85.4,0.0,0.1,0.3,1.6,0.0,98.2,0.0,109222,96941,95928,38111,95236,7,94,312,1791,0,109526,5,13294,95928,7,87,218,1479,11.9,86.0,0.0,0.1,0.2,1.3
E06000003,REDCAR AND CLEVELAND,68507,68315,96.8,86.5,85.5,2.8,2.8,0.1,0.6,1.3,2.9,0.3,98.0,0.1,66297,59249,58572,1922,1922,101,386,907,2018,214,67155,51,7725,58572,101,285,521,1111,11.3,85.5,0.1,0.4,0.8,1.6
E07000236,REDDITCH,39590,39404,98.0,81.4,80.7,6.9,80.7,0.0,0.0,0.1,1.6,0.0,98.8,0.0,38790,32245,31951,2728,31950,3,12,49,614,3,39134,0,6839,31951,3,9,37,565,17.3,80.7,0.0,0.0,0.1,1.4
E07000211,REIGATE AND BANSTEAD,64477,64328,97.3,79.6,79.1,25.8,25.8,0.0,0.1,0.2,2.4,0.1,99.6,0.0,62763,51347,50972,16636,16645,18,86,154,1565,34,64215,0,11791,50972,18,68,68,1411,18.3,79.1,0.0,0.1,0.1,2.2
S12000038,RENFREWSHIRE,95282,95093,96.7,83.9,83.9,37.3,76.2,0.1,0.3,0.7,3.1,0.1,98.3,0.0,92158,79968,79945,35526,72561,106,295,648,2935,66,93641,0,12213,79945,106,189,353,2287,12.8,83.9,0.1,0.2,0.4,2.4
W06000016,RHONDDA CYNON TAF,119137,118315,97.2,29.9,27.0,18.1,25.4,0.0,0.1,0.3,2.1,0.1,98.8,26.8,115764,35651,32207,21575,30248,53,102,385,2551,95,117657,31977,83557,32207,53,49,283,2166,70.1,27.0,0.0,0.0,0.2,1.8
E07000124,RIBBLE VALLEY,30591,30373,90.5,43.1,42.8,41.8,42.1,0.7,2.1,3.6,8.8,0.6,98.1,80.7,27679,13175,13092,12779,12879,222,645,1092,2694,169,30008,24676,14587,13092,222,423,447,1602,47.7,42.8,0.7,1.4,1.5,5.2
E09000027,RICHMOND UPON THAMES,88890,88622,98.1,88.6,87.1,29.4,86.2,0.0,0.0,0.2,1.6,0.0,98.3,0.0,87220,78790,77449,26126,76619,0,16,199,1402,4,87365,0,9771,77449,0,16,183,1203,11.0,87.1,0.0,0.0,0.2,1.4
E07000166,RICHMONDSHIRE,25267,24993,84.2,24.3,13.0,5.8,5.8,2.3,4.8,7.7,14.7,3.1,95.7,21.7,21281,6131,3278,1456,1456,580,1225,1952,3712,785,24183,5480,18003,3278,580,645,727,1760,71.3,13.0,2.3,2.6,2.9,7.0
E08000005,ROCHDALE,101633,101167,97.4,71.1,65.2,11.4,11.4,0.0,0.1,0.4,2.2,0.0,99.0,0.0,98977,72245,66271,11603,11613,29,133,373,2190,31,100611,0,32706,66271,29,104,240,1817,32.2,65.2,0.0,0.1,0.2,1.8
E07000075,ROCHFORD,38206,37898,97.7,22.4,17.1,13.3,13.3,0.0,0.1,0.3,1.5,0.1,98.9,0.0,37324,8547,6546,5094,5094,2,57,108,574,36,37798,1,30778,6546,2,55,51,466,80.6,17.1,0.0,0.1,0.1,1.2
E07000125,ROSSENDALE,35012,34718,93.5,52.5,43.2,1.5,1.5,0.1,0.8,1.0,5.7,0.2,98.1,0.1,32724,18384,15137,530,530,35,271,360,1994,72,34354,51,17587,15137,35,236,89,1634,50.2,43.2,0.1,0.7,0.3,4.7
E07000064,ROTHER,49557,49122,93.5,7.7,7.7,7.7,7.7,0.1,0.3,1.0,5.6,0.2,98.8,0.7,46353,3817,3817,3817,3817,45,140,504,2769,112,48980,340,42536,3817,45,95,364,2265,85.8,7.7,0.1,0.2,0.7,4.6
E08000018,ROTHERHAM,125237,124728,98.0,63.3,61.1,20.5,20.5,0.0,0.2,0.4,1.6,0.1,99.0,0.5,122731,79331,76492,25630,25631,29,209,536,1997,66,124037,566,46239,76492,29,180,327,1461,36.9,61.1,0.0,0.1,0.3,1.2
E07000220,RUGBY,50947,50722,97.2,69.6,66.0,19.0,63.2,0.3,0.6,0.8,2.3,0.2,98.9,0.0,49531,35439,33635,9692,32220,131,291,421,1191,103,50376,0,15896,33635,131,160,130,770,31.2,66.0,0.3,0.3,0.3,1.5
E07000212,RUNNYMEDE,38771,38523,96.2,73.2,70.9,6.8,67.1,0.0,0.1,0.7,3.1,0.0,97.6,0.0,37306,28380,27490,2648,26025,2,49,289,1217,15,37825,0,9816,27490,2,47,240,928,25.3,70.9,0.0,0.1,0.6,2.4
E07000176,RUSHCLIFFE,54657,54433,97.0,76.3,73.3,37.6,37.6,0.2,0.4,0.8,2.6,0.2,99.2,9.3,53029,41690,40053,20562,20565,100,232,455,1404,116,54239,5062,12976,40053,100,132,223,949,23.7,73.3,0.2,0.2,0.4,1.7
E07000092,RUSHMOOR,43087,42913,97.0,81.7,81.4,4.8,51.0,0.1,0.9,1.7,2.6,0.4,97.3,0.0,41784,35200,35090,2053,21953,52,383,721,1129,178,41907,0,6694,35090,52,331,338,408,15.5,81.4,0.1,0.8,0.8,0.9
E06000017,RUTLAND,18726,18628,90.6,14.4,14.4,14.4,14.4,0.3,0.5,0.9,8.9,0.3,98.9,0.0,16965,2705,2705,2705,2705,53,91,177,1663,53,18519,9,14260,2705,53,38,86,1486,76.2,14.4,0.3,0.2,0.5,7.9
E07000167,RYEDALE,30351,29700,85.0,10.4,10.4,10.4,10.4,2.7,4.7,6.9,12.8,3.6,94.4,25.7,25806,3166,3166,3166,3166,809,1435,2087,3894,1088,28651,7803,22640,3166,809,626,652,1807,74.6,10.4,2.7,2.1,2.1,6.0
E08000006,SALFORD,129751,129227,95.6,83.6,83.2,58.2,82.9,0.0,0.7,1.9,4.0,0.0,95.8,0.0,124041,108495,107924,75465,107541,12,951,2499,5186,15,124335,0,16117,107924,12,939,1548,2687,12.4,83.2,0.0,0.7,1.2,2.1
E08000028,SANDWELL,142647,142161,99.0,84.3,82.8,19.4,82.0,0.0,0.0,0.2,0.7,0.0,99.1,0.0,141224,120243,118081,27715,117012,16,39,344,937,4,141303,0,23143,118081,16,23,305,593,16.2,82.8,0.0,0.0,0.2,0.4
E07000168,SCARBOROUGH,63713,63365,93.7,3.8,3.8,3.8,3.8,0.7,1.2,1.8,5.8,0.9,97.8,4.5,59670,2394,2394,2391,2391,418,778,1148,3695,549,62325,2896,57276,2394,418,360,370,2547,89.9,3.8,0.7,0.6,0.6,4.0
S12000026,SCOTTISH BORDERS,64825,63510,85.1,22.6,19.7,17.7,17.7,1.8,4.3,7.3,12.9,3.2,94.2,15.5,55150,14634,12764,11454,11454,1173,2770,4718,8360,2042,61052,10075,42386,12764,1173,1597,1948,3642,65.4,19.7,1.8,2.5,3.0,5.6
E07000188,SEDGEMOOR,59833,59555,93.7,44.0,34.8,29.3,29.3,0.2,0.8,1.8,5.8,0.5,97.6,0.0,56057,26312,20823,17555,17555,122,466,1051,3498,306,58368,0,35234,20823,122,344,585,2447,58.9,34.8,0.2,0.6,1.0,4.1
E08000014,SEFTON,135702,135080,98.4,74.5,68.9,39.7,64.4,0.0,0.1,0.2,1.2,0.0,99.2,0.2,133514,101146,93538,53857,87388,5,82,235,1566,49,134631,325,39976,93538,5,77,153,1331,29.5,68.9,0.0,0.1,0.1,1.0
E07000169,SELBY,43592,43152,92.8,21.6,21.6,21.6,21.6,0.6,1.1,1.9,6.2,0.5,97.5,31.1,40454,9432,9431,9429,9431,275,500,847,2698,213,42485,13565,31023,9431,275,225,347,1851,71.2,21.6,0.6,0.5,0.8,4.2
E07000111,SEVENOAKS,53496,53253,93.7,60.2,60.1,36.0,54.7,0.1,0.5,1.1,5.8,0.2,99.1,0.0,50132,32231,32141,19281,29255,80,256,564,3121,131,53022,0,17991,32141,80,176,308,2557,33.6,60.1,0.1,0.3,0.6,4.8
E08000019,SHEFFIELD,262555,261329,96.3,56.3,53.0,21.1,21.1,0.0,0.1,0.6,3.2,0.0,97.2,0.1,252835,147756,139034,55294,55295,58,248,1616,8494,81,255248,198,113801,139034,58,190,1368,6878,43.3,53.0,0.0,0.1,0.5,2.6
S12000027,SHETLAND ISLANDS,11947,11497,69.7,2.1,2.1,2.1,2.1,3.0,7.3,16.6,26.5,6.1,83.2,0.0,8333,250,250,250,250,363,870,1986,3164,725,9938,0,8083,250,363,507,1116,1178,67.7,2.1,3.0,4.2,9.3,9.9
E06000051,SHROPSHIRE,154149,152985,85.8,23.3,17.7,11.2,14.1,1.0,3.0,5.7,13.4,0.7,95.3,76.7,132280,35987,27331,17296,21692,1471,4586,8789,20705,1082,146943,118161,104949,27331,1471,3115,4203,11916,68.1,17.7,1.0,2.0,2.7,7.7
E06000039,SLOUGH,57855,57616,98.5,93.0,90.3,59.0,59.6,0.0,0.1,0.2,1.1,0.0,98.7,0.0,56999,53813,52244,34148,34488,7,32,96,617,1,57090,0,4755,52244,7,25,64,521,8.2,90.3,0.0,0.0,0.1,0.9
E08000029,SOLIHULL,97978,97240,97.2,89.1,87.8,37.6,87.3,0.0,0.1,0.8,2.0,0.0,97.7,0.0,95280,87261,86024,36828,85491,33,129,793,1960,21,95752,1,9256,86024,33,96,664,1167,9.4,87.8,0.0,0.1,0.7,1.2
E07000246,SOMERSET WEST AND TAUNTON,78317,77778,88.8,32.5,25.7,20.2,20.2,0.8,2.5,4.5,10.5,1.4,96.0,5.5,69565,25457,20092,15854,15854,657,1938,3545,8213,1079,75171,4269,49473,20092,657,1281,1607,4668,63.2,25.7,0.8,1.6,2.1,6.0
S12000028,SOUTH AYRSHIRE,58838,58746,94.5,61.6,60.9,25.8,25.8,0.3,1.1,2.2,5.4,0.8,98.7,0.0,55584,36249,35825,15173,15173,180,624,1323,3162,461,58064,0,19759,35825,180,444,699,1839,33.6,60.9,0.3,0.8,1.2,3.1
E07000012,SOUTH CAMBRIDGESHIRE,71828,71385,95.7,60.0,58.1,20.1,20.1,0.2,0.5,1.2,3.7,0.3,98.2,0.1,68739,43117,41756,14470,14473,140,347,875,2646,208,70521,77,26983,41756,140,207,528,1771,37.6,58.1,0.2,0.3,0.7,2.5
E07000039,SOUTH DERBYSHIRE,49630,49096,93.9,46.1,42.9,38.6,38.6,0.2,0.8,1.2,5.0,0.7,98.2,0.0,46613,22883,21291,19172,19172,123,383,613,2483,368,48740,0,25322,21291,123,260,230,1870,51.0,42.9,0.2,0.5,0.5,3.8
E06000025,SOUTH GLOUCESTERSHIRE,127442,126861,98.0,80.4,79.3,13.9,79.1,0.1,0.2,0.5,1.5,0.1,99.1,0.0,124903,102434,101076,17755,100841,92,225,622,1958,145,126263,1,23827,101076,92,133,397,1336,18.7,79.3,0.1,0.1,0.3,1.0
E07000044,SOUTH HAMS,48902,48475,81.8,28.3,27.7,23.9,23.9,0.8,2.8,7.0,17.3,2.4,94.1,27.9,39999,13848,13525,11708,11708,392,1386,3447,8476,1172,45997,13635,26474,13525,392,994,2061,5029,54.1,27.7,0.8,2.0,4.2,10.3
E07000140,SOUTH HOLLAND,44535,44140,88.4,13.5,10.1,8.0,8.0,0.5,1.6,3.0,10.7,1.2,98.3,1.0,39387,5993,4479,3568,3570,202,720,1346,4753,532,43785,439,34908,4479,202,518,626,3407,78.4,10.1,0.5,1.2,1.4,7.7
E07000141,SOUTH KESTEVEN,68834,68518,92.8,34.4,32.9,7.0,7.0,0.9,1.4,2.0,6.7,0.3,98.2,2.4,63903,23663,22629,4821,4821,649,996,1394,4615,226,67588,1623,41274,22629,649,347,398,3221,60.0,32.9,0.9,0.5,0.6,4.7
E07000031,SOUTH LAKELAND,60588,60231,93.1,15.1,13.6,12.7,12.7,0.4,1.0,1.7,6.3,0.9,98.2,33.8,56418,9146,8242,7665,7665,233,593,1050,3813,533,59494,20480,48176,8242,233,360,457,2763,79.5,13.6,0.4,0.6,0.8,4.6
S12000029,SOUTH LANARKSHIRE,161058,160618,96.1,73.6,73.2,20.1,72.9,0.4,1.0,1.7,3.7,0.3,98.6,0.0,154735,118555,117942,32364,117404,676,1533,2788,5883,557,158791,0,36793,117942,676,857,1255,3095,22.8,73.2,0.4,0.5,0.8,1.9
E07000149,SOUTH NORFOLK,66426,66073,91.5,19.0,18.3,13.8,13.8,0.4,1.3,2.4,8.0,1.3,98.3,0.0,60784,12598,12149,9154,9154,235,865,1591,5289,883,65322,0,48635,12149,235,630,726,3698,73.2,18.3,0.4,0.9,1.1,5.6
E07000179,SOUTH OXFORDSHIRE,67244,66964,96.0,51.4,46.6,24.2,24.2,0.1,0.3,0.7,3.6,0.2,99.3,0.0,64568,34580,31305,16281,16282,69,230,458,2396,154,66790,0,33263,31305,69,161,228,1938,49.5,46.6,0.1,0.2,0.3,2.9
E07000126,SOUTH RIBBLE,53414,53213,96.7,69.5,68.3,10.2,10.2,0.0,0.4,0.8,3.0,0.0,98.8,35.0,51632,37102,36490,5436,5436,26,215,430,1581,17,52769,18688,15142,36490,26,189,215,1151,28.3,68.3,0.0,0.4,0.4,2.2
E07000189,SOUTH SOMERSET,84410,83401,88.7,13.2,12.9,12.8,12.8,0.6,1.9,3.6,10.1,0.7,96.5,1.6,74894,11122,10862,10770,10770,469,1628,3005,8507,607,81434,1375,64032,10862,469,1159,1377,5502,75.9,12.9,0.6,1.4,1.6,6.5
E07000196,SOUTH STAFFORDSHIRE,50059,49829,92.2,37.0,32.9,29.8,30.0,0.2,0.9,2.0,7.4,0.1,98.6,5.1,46143,18541,16492,14900,15024,103,447,979,3686,59,49344,2560,29651,16492,103,344,532,2707,59.2,32.9,0.2,0.7,1.1,5.4
E08000023,SOUTH TYNESIDE,75767,75698,97.7,77.1,76.5,1.7,76.3,0.1,0.3,0.5,2.2,0.0,98.8,0.0,74032,58380,57962,1285,57806,46,230,416,1666,3,74835,0,16070,57962,46,184,186,1250,21.2,76.5,0.1,0.2,0.2,1.6
E06000045,SOUTHAMPTON,113869,113661,97.5,93.7,92.5,52.1,88.6,0.0,0.0,0.3,2.3,0.0,97.8,0.0,111050,106662,105322,59315,100922,5,31,371,2611,7,111381,0,5728,105322,5,26,340,2240,5.0,92.5,0.0,0.0,0.3,2.0
E06000033,SOUTHEND-ON-SEA,87046,86662,97.9,78.8,72.9,41.3,41.3,0.0,0.0,0.0,1.6,0.0,98.2,0.2,85258,68589,63459,35992,35992,0,2,16,1404,2,85463,162,21799,63459,0,2,14,1388,25.0,72.9,0.0,0.0,0.0,1.6
E09000028,SOUTHWARK,150363,149438,93.9,80.8,79.9,53.8,79.7,0.0,0.0,0.2,5.5,0.0,93.9,0.0,141204,121459,120213,80850,119907,0,62,242,8234,1,141229,0,20991,120213,0,62,180,7992,14.0,79.9,0.0,0.0,0.1,5.3
E07000213,SPELTHORNE,45230,45031,97.0,83.9,82.5,23.3,23.3,0.0,0.0,0.6,2.6,0.0,97.6,0.0,43864,37954,37300,10557,10561,0,15,277,1167,2,44163,0,6564,37300,0,15,262,890,14.5,82.5,0.0,0.0,0.6,2.0
E07000240,ST ALBANS,64973,64723,97.2,86.9,85.1,41.9,41.9,0.0,0.1,0.3,2.4,0.1,98.5,0.0,63165,56433,55282,27204,27204,28,69,183,1558,34,64005,0,7883,55282,28,41,114,1375,12.1,85.1,0.0,0.1,0.2,2.1
E08000013,ST. HELENS,88756,88466,97.0,84.4,83.7,6.8,83.6,0.1,0.5,0.8,2.6,0.1,98.5,42.0,86114,74938,74285,5999,74179,125,408,734,2352,81,87450,37297,11829,74285,125,283,326,1618,13.3,83.7,0.1,0.3,0.4,1.8
E07000197,STAFFORD,65489,65291,94.1,67.0,66.8,20.0,22.7,0.3,0.8,1.7,5.6,0.3,98.5,0.6,61628,43864,43758,13117,14847,186,529,1121,3663,228,64484,387,17870,43758,186,343,592,2542,27.3,66.8,0.3,0.5,0.9,3.9
E07000198,STAFFORDSHIRE MOORLANDS,46752,46516,90.6,28.5,27.5,3.4,3.4,0.7,1.6,3.2,8.9,1.1,97.5,0.0,42351,13323,12880,1584,1584,308,764,1515,4165,510,45580,0,29471,12880,308,456,751,2650,63.0,27.5,0.7,1.0,1.6,5.7
E07000243,STEVENAGE,39638,39442,98.8,87.2,87.0,3.6,3.6,0.0,0.0,0.1,0.7,0.0,98.9,0.0,39180,34583,34468,1412,1412,0,18,37,262,0,39218,0,4712,34468,0,18,19,225,11.9,87.0,0.0,0.0,0.0,0.6
S12000030,STIRLING,46487,45914,88.7,52.6,50.2,49.3,49.4,1.4,3.0,4.7,10.1,2.5,96.0,0.0,41221,24445,23357,22941,22949,641,1394,2204,4693,1145,44612,0,17864,23357,641,753,810,2489,38.4,50.2,1.4,1.6,1.7,5.4
E08000007,STOCKPORT,140415,139302,97.8,85.5,85.4,10.9,36.0,0.0,0.1,0.2,1.4,0.0,98.5,8.0,137363,120104,119884,15316,50567,24,210,302,1939,26,138351,11215,17479,119884,24,186,92,1637,12.4,85.4,0.0,0.1,0.1,1.2
E06000004,STOCKTON-ON-TEES,92901,92654,95.9,89.0,88.3,7.5,7.5,0.1,0.6,1.6,3.8,0.2,96.5,21.3,89134,82653,82029,6998,6998,82,583,1474,3520,151,89677,19766,7105,82029,82,501,891,2046,7.6,88.3,0.1,0.5,1.0,2.2
E06000021,STOKE-ON-TRENT,123673,123131,97.7,83.6,83.6,23.5,23.5,0.0,0.1,0.3,1.9,0.1,98.4,0.0,120771,103406,103352,29110,29110,0,76,427,2360,122,121722,0,17419,103352,0,76,351,1933,14.1,83.6,0.0,0.1,0.3,1.6
E07000221,STRATFORD-ON-AVON,66797,66270,94.0,47.1,42.0,21.6,38.2,0.4,1.0,1.8,5.2,0.5,97.8,0.2,62781,31482,28061,14435,25485,254,660,1186,3489,362,65355,123,34720,28061,254,406,526,2303,52.0,42.0,0.4,0.6,0.8,3.4
E07000082,STROUD,57707,57395,91.5,24.1,24.0,20.5,24.0,0.3,0.9,2.1,7.9,0.3,95.2,0.2,52809,13890,13870,11810,13874,161,526,1198,4586,168,54961,94,38939,13870,161,365,672,3388,67.5,24.0,0.3,0.6,1.2,5.9
E08000024,SUNDERLAND,137589,136824,96.2,66.4,62.6,11.4,60.4,0.1,0.2,0.8,3.2,0.1,97.6,0.0,132413,91355,86069,15628,83105,90,312,1093,4411,102,134241,0,46344,86069,90,222,781,3318,33.7,62.6,0.1,0.2,0.6,2.4
E07000214,SURREY HEATH,39072,38933,97.7,67.9,67.1,12.9,12.9,0.0,0.0,0.1,1.9,0.0,99.5,0.0,38177,26518,26210,5050,5054,1,16,49,756,3,38891,0,11967,26210,1,15,33,707,30.6,67.1,0.0,0.0,0.1,1.8
E09000029,SUTTON,87487,87236,98.1,86.5,84.6,8.4,83.7,0.0,0.0,0.1,1.6,0.0,98.4,0.0,85865,75699,73984,7363,73236,11,18,109,1371,1,86078,0,11881,73984,11,7,91,1262,13.6,84.6,0.0,0.0,0.1,1.4
E07000113,SWALE,67905,67322,93.2,55.9,50.7,23.9,23.9,0.2,0.7,1.6,5.9,0.2,98.2,29.5,63319,37980,34455,16201,16201,135,487,1093,4003,142,66674,20030,28864,34455,135,352,606,2910,42.5,50.7,0.2,0.5,0.9,4.3
W06000011,SWANSEA,118980,118442,97.6,81.1,78.6,31.9,53.9,0.1,0.2,0.6,1.9,0.1,98.5,49.2,116158,96469,93496,37987,64103,119,274,686,2284,170,117211,58583,22662,93496,119,155,412,1598,19.0,78.6,0.1,0.1,0.3,1.3
E06000030,SWINDON,102582,102467,93.0,85.3,82.6,34.6,34.6,0.0,0.8,1.7,6.9,0.5,93.4,0.0,95378,87461,84699,35499,35499,38,833,1748,7089,480,95842,0,10679,84699,38,795,915,5341,10.4,82.6,0.0,0.8,0.9,5.2
E08000008,TAMESIDE,116166,115508,96.9,59.2,58.3,19.9,45.8,0.0,0.0,0.2,2.6,0.0,99.0,0.0,112519,68756,67750,23097,53186,5,38,178,2989,4,114986,0,44769,67750,5,33,140,2811,38.5,58.3,0.0,0.0,0.1,2.4
E07000199,TAMWORTH,35728,35628,99.0,85.3,82.2,4.7,79.8,0.1,0.1,0.2,0.8,0.0,99.4,0.0,35357,30481,29372,1662,28517,34,41,77,271,1,35520,0,5985,29372,34,7,36,194,16.8,82.2,0.1,0.0,0.1,0.5
E07000215,TANDRIDGE,38690,38475,93.2,56.2,54.6,15.4,15.4,0.1,0.7,1.2,6.2,0.2,98.9,0.0,36076,21734,21120,5953,5970,51,252,456,2399,95,38277,0,14956,21120,51,201,204,1943,38.7,54.6,0.1,0.5,0.5,5.0
E07000045,TEIGNBRIDGE,66765,66363,88.4,37.6,37.4,12.1,12.1,0.4,1.7,3.6,11.0,0.8,96.4,28.7,59035,25120,24983,8049,8049,296,1137,2396,7328,557,64359,19194,34052,24983,296,841,1259,4932,51.0,37.4,0.4,1.3,1.9,7.4
E06000020,TELFORD AND WREKIN,82987,82553,97.5,82.0,79.5,11.1,77.8,0.1,0.2,0.4,2.0,0.1,98.8,38.0,80874,68055,65952,9172,64581,46,145,324,1679,49,81975,31503,14922,65952,46,99,179,1355,18.0,79.5,0.1,0.1,0.2,1.6
E07000076,TENDRING,75113,74526,97.6,12.1,12.1,12.1,12.1,0.1,0.2,0.4,1.7,0.1,98.8,2.9,73282,9103,9103,9096,9096,55,113,284,1244,74,74191,2190,64179,9103,55,58,171,960,85.4,12.1,0.1,0.1,0.2,1.3
E07000093,TEST VALLEY,60057,59840,93.4,66.7,65.7,18.0,61.6,0.2,0.8,2.0,6.2,0.6,98.4,0.0,56116,40048,39451,10820,36993,113,473,1207,3724,390,59112,0,16665,39451,113,360,734,2517,27.7,65.7,0.2,0.6,1.2,4.2
E07000083,TEWKESBURY,47410,46233,90.2,59.0,56.6,27.6,55.2,0.2,1.0,2.0,7.3,0.5,92.1,0.3,42754,27990,26843,13104,26175,86,457,966,3479,250,43648,136,15911,26843,86,371,509,2513,33.6,56.6,0.2,0.8,1.1,5.3
E07000114,THANET,73508,72881,96.9,61.3,61.2,61.1,61.1,0.0,0.6,1.2,2.3,0.0,98.8,24.5,71213,45042,44990,44947,44947,13,460,918,1668,4,72618,18013,26223,44990,13,447,458,750,35.7,61.2,0.0,0.6,0.6,1.0
E07000102,THREE RIVERS,39763,39606,96.8,82.5,80.0,39.0,39.0,0.2,0.3,0.5,2.8,0.0,99.4,0.0,38504,32802,31822,15503,15520,72,100,190,1102,11,39508,0,6682,31822,72,28,90,912,16.8,80.0,0.2,0.1,0.2,2.3
E06000034,THURROCK,72482,72234,95.6,78.7,77.4,24.6,24.6,0.1,0.6,1.6,4.1,0.2,97.1,0.0,69285,57040,56123,17852,17852,58,400,1194,2949,127,70367,5,13162,56123,58,342,794,1755,18.2,77.4,0.1,0.5,1.1,2.4
E07000115,TONBRIDGE AND MALLING,57489,57266,94.6,67.8,65.6,24.1,24.1,0.1,0.4,1.2,5.1,0.3,98.3,8.3,54360,38960,37692,13873,13873,75,254,665,2906,160,56526,4755,16668,37692,75,179,411,2241,29.0,65.6,0.1,0.3,0.7,3.9
E06000027,TORBAY,78319,77602,94.5,78.6,76.0,45.7,45.7,0.0,0.0,0.5,4.6,0.0,96.7,0.2,74029,61578,59557,35761,35761,15,30,374,3573,21,75701,129,14472,59557,15,15,344,3199,18.5,76.0,0.0,0.0,0.4,4.1
W06000020,TORFAEN,46092,45833,95.8,50.0,41.5,12.7,12.7,0.2,0.5,1.3,3.6,0.2,97.2,65.0,44175,23061,19120,5870,5870,72,232,595,1658,109,44785,29942,25055,19120,72,160,363,1063,54.4,41.5,0.2,0.3,0.8,2.3
E07000046,TORRIDGE,34548,34156,80.6,6.1,6.1,6.1,6.1,2.5,6.5,10.7,18.2,1.9,92.5,46.1,27857,2113,2112,2112,2112,855,2260,3700,6299,650,31948,15938,25745,2112,855,1405,1440,2599,74.5,6.1,2.5,4.1,4.2,7.5
E09000030,TOWER HAMLETS,148082,146880,93.5,76.3,73.5,59.1,71.8,0.0,0.0,0.6,5.7,0.0,93.6,0.0,138506,113043,108902,87471,106297,0,53,863,8374,0,138548,0,29604,108902,0,53,810,7511,20.0,73.5,0.0,0.0,0.5,5.1
E08000009,TRAFFORD,107871,107502,97.7,71.5,67.0,3.5,63.7,0.1,0.2,0.3,2.0,0.0,98.9,0.1,105372,77099,72258,3817,68701,61,249,372,2130,28,106634,109,33114,72258,61,188,123,1758,30.7,67.0,0.1,0.2,0.1,1.6
E07000116,TUNBRIDGE WELLS,53172,52776,92.7,64.0,60.8,34.6,34.6,0.1,0.9,2.0,6.6,0.7,97.9,0.1,49284,34043,32327,18423,18423,47,492,1070,3492,370,52078,78,16957,32327,47,445,578,2422,31.9,60.8,0.1,0.8,1.1,4.6
E07000077,UTTLESFORD,41332,40933,92.8,55.4,53.4,37.1,37.1,0.4,1.0,2.8,6.2,0.9,96.1,2.6,38368,22902,22056,15333,15333,148,405,1139,2565,360,39718,1061,16312,22056,148,257,734,1426,39.5,53.4,0.4,0.6,1.8,3.5
W06000014,VALE OF GLAMORGAN,63240,62702,96.3,66.2,62.4,44.3,59.8,0.2,0.9,1.3,2.8,0.5,97.7,10.4,60922,41840,39487,28033,37807,136,591,853,1780,297,61801,6570,21435,39487,136,455,262,927,33.9,62.4,0.2,0.7,0.4,1.5
E07000180,VALE OF WHITE HORSE,63102,62804,96.1,64.2,61.9,19.0,19.0,0.1,0.3,0.7,3.4,0.1,98.7,0.0,60633,40532,39078,11967,11968,70,180,424,2171,78,62258,0,21555,39078,70,110,244,1747,34.2,61.9,0.1,0.2,0.4,2.8
E08000036,WAKEFIELD,159975,159293,96.1,60.0,59.7,26.1,26.1,0.0,0.3,0.6,3.5,0.1,98.2,9.4,153660,96000,95451,41828,41829,76,499,981,5633,122,157041,14995,58209,95451,76,423,482,4652,36.4,59.7,0.0,0.3,0.3,2.9
E08000030,WALSALL,117862,117456,98.1,79.3,77.3,11.9,76.5,0.0,0.0,0.5,1.5,0.0,98.7,0.0,115635,93437,91133,14036,90155,4,24,570,1821,45,116306,0,24502,91133,4,20,546,1251,20.8,77.3,0.0,0.0,0.5,1.1
E09000031,WALTHAM FOREST,111384,110800,95.8,88.0,87.0,20.1,86.5,0.0,0.1,0.8,3.7,0.0,95.9,0.0,106726,98016,96959,22397,96391,33,166,889,4074,24,106823,0,9767,96959,33,133,723,3185,8.8,87.0,0.0,0.1,0.6,2.9
E09000032,WANDSWORTH,157231,155852,96.9,87.5,81.7,43.3,76.4,0.0,0.0,0.2,2.2,0.0,97.0,0.0,152419,137589,128442,68156,120129,0,4,298,3433,2,152458,1,23977,128442,0,4,294,3135,15.2,81.7,0.0,0.0,0.2,2.0
E06000007,WARRINGTON,100135,99220,97.1,79.8,77.9,14.3,76.7,0.0,0.1,0.2,2.0,0.0,98.5,1.0,97194,79878,77978,14306,76841,41,116,201,2026,34,98590,1035,19216,77978,41,75,85,1825,19.2,77.9,0.0,0.1,0.1,1.8
E07000222,WARWICK,69938,69712,97.9,80.0,74.4,12.0,70.8,0.1,0.4,0.6,1.8,0.0,99.2,0.0,68481,55969,52067,8363,49543,85,283,433,1231,31,69355,0,16414,52067,85,198,150,798,23.5,74.4,0.1,0.3,0.2,1.1
E07000103,WATFORD,42604,42338,98.9,91.3,87.5,22.9,22.9,0.0,0.0,0.1,0.5,0.0,98.9,0.0,42121,38909,37269,9759,9761,0,16,59,217,0,42149,0,4852,37269,0,16,43,158,11.4,87.5,0.0,0.0,0.1,0.4
E07000216,WAVERLEY,57104,56883,93.6,27.6,24.7,14.5,14.5,0.2,0.5,0.9,6.0,0.4,99.2,0.0,53430,15789,14099,8277,8277,123,310,513,3453,233,56656,0,39331,14099,123,187,203,2940,68.9,24.7,0.2,0.3,0.4,5.1
E07000065,WEALDEN,74740,74423,94.8,43.4,43.2,43.2,43.2,0.1,0.6,1.2,4.8,0.5,99.1,0.0,70863,32429,32299,32266,32266,101,418,880,3560,381,74035,0,38564,32299,101,317,462,2680,51.6,43.2,0.1,0.4,0.6,3.6
E07000241,WELWYN HATFIELD,50678,50567,97.1,77.4,75.4,12.0,70.4,0.0,0.1,0.4,2.7,0.0,99.1,0.0,49203,39233,38224,6081,35662,9,44,184,1364,6,50207,0,10979,38224,9,35,140,1180,21.7,75.4,0.0,0.1,0.3,2.3
E06000037,WEST BERKSHIRE,72404,72009,97.2,74.6,69.8,28.8,66.4,0.0,0.4,0.6,2.3,0.1,98.2,0.0,70352,54010,50543,20852,48070,20,274,424,1657,91,71115,1,19809,50543,20,254,150,1233,27.4,69.8,0.0,0.4,0.2,1.7
E07000047,WEST DEVON,27184,27016,78.9,34.5,34.5,34.5,34.5,1.8,5.9,11.7,20.4,1.8,95.2,67.6,21461,9384,9384,9384,9384,479,1606,3174,5555,502,25870,18375,12077,9384,479,1127,1568,2381,44.4,34.5,1.8,4.1,5.8,8.8
S12000039,WEST DUNBARTONSHIRE,47127,47091,98.3,89.6,88.4,1.3,87.3,0.0,0.2,0.5,1.6,0.0,99.0,0.0,46325,42247,41650,612,41119,23,92,226,766,16,46675,0,4675,41650,23,69,134,540,9.9,88.4,0.0,0.1,0.3,1.1
E07000127,WEST LANCASHIRE,52430,52223,95.1,54.9,46.5,40.7,40.9,0.2,0.7,1.3,4.5,0.1,98.8,26.3,49887,28762,24386,21353,21425,117,393,666,2336,47,51780,13799,25501,24386,117,276,273,1670,48.6,46.5,0.2,0.5,0.5,3.2
E07000142,WEST LINDSEY,46600,46139,85.4,35.5,33.4,21.7,21.7,2.1,4.4,6.7,13.6,1.6,96.5,35.2,39817,16552,15564,10100,10102,956,2057,3128,6322,757,44984,16424,24253,15564,956,1101,1071,3194,52.0,33.4,2.1,2.4,2.3,6.9
S12000040,WEST LOTHIAN,86888,86614,97.1,80.8,79.6,44.0,78.7,0.2,0.4,0.9,2.6,0.2,98.8,0.0,84327,70209,69140,38245,68410,140,317,803,2287,166,85824,2,15187,69140,140,177,486,1484,17.5,79.6,0.2,0.2,0.6,1.7
E06000062,WEST NORTHAMPTONSHIRE,187902,185869,96.6,71.8,68.9,41.5,67.2,0.1,0.6,0.9,2.3,0.2,97.7,0.2,181558,134855,129465,78051,126226,227,1112,1747,4311,343,183592,401,52093,129465,227,885,635,2564,27.7,68.9,0.1,0.5,0.3,1.4
E07000181,WEST OXFORDSHIRE,53358,53103,98.7,77.6,72.4,42.2,42.2,0.0,0.0,0.1,0.8,0.1,99.2,0.0,52680,41392,38655,22536,22536,10,22,57,423,74,52944,11,14025,38655,10,12,35,366,26.3,72.4,0.0,0.0,0.1,0.7
E07000245,WEST SUFFOLK,85492,84869,94.9,35.8,29.9,17.3,17.3,0.2,0.4,0.6,4.4,0.3,98.7,0.3,81105,30575,25580,14748,14748,139,310,534,3764,240,84339,240,55525,25580,139,171,224,3230,64.9,29.9,0.2,0.2,0.3,3.8
E09000033,WESTMINSTER,164556,162621,89.8,70.0,69.1,65.1,67.8,0.0,0.0,0.1,9.0,0.0,89.8,0.0,147761,115226,113762,107163,111617,0,0,87,14860,12,147791,0,33999,113762,0,0,87,14773,20.7,69.1,0.0,0.0,0.1,9.0
E08000010,WIGAN,154218,154103,98.4,87.2,86.1,6.0,85.7,0.0,0.1,0.2,1.5,0.0,99.5,28.1,151726,134519,132801,9185,132110,32,135,352,2377,16,153481,43280,18925,132801,32,103,217,2025,12.3,86.1,0.0,0.1,0.1,1.3
E06000054,WILTSHIRE,235180,234154,94.9,49.8,48.4,26.9,31.3,0.2,0.6,1.3,4.7,0.4,98.6,0.7,223082,117179,113941,63161,73624,454,1513,2987,11072,934,232001,1548,109141,113941,454,1059,1474,8085,46.4,48.4,0.2,0.5,0.6,3.4
E07000094,WINCHESTER,57203,56842,90.7,46.3,44.6,9.3,9.3,0.4,1.4,2.5,8.7,0.6,96.8,0.0,51872,26511,25487,5300,5321,253,813,1455,4970,364,55358,0,26385,25487,253,560,642,3515,46.1,44.6,0.4,1.0,1.1,6.1
E06000040,WINDSOR AND MAIDENHEAD,67776,67541,95.5,69.6,65.6,15.8,15.8,0.0,0.2,0.7,4.1,0.1,98.0,0.0,64735,47193,44450,10693,10694,33,126,449,2806,58,66430,3,20285,44450,33,93,323,2357,29.9,65.6,0.0,0.1,0.5,3.5
E08000015,WIRRAL,158617,158268,98.0,76.8,76.6,63.8,63.8,0.0,0.1,0.1,1.8,0.0,99.5,0.0,155403,121771,121472,101148,101149,48,110,176,2865,24,157774,0,33931,121472,48,62,66,2689,21.4,76.6,0.0,0.0,0.0,1.7
E07000217,WOKING,45864,45273,97.2,84.1,80.5,3.9,3.9,0.0,0.3,0.3,1.5,0.2,98.2,0.0,44581,38577,36939,1782,1783,1,143,160,692,114,45059,0,7642,36939,1,142,17,532,16.7,80.5,0.0,0.3,0.0,1.2
E06000041,WOKINGHAM,76741,75396,94.8,72.6,69.1,14.7,67.3,0.0,0.1,0.4,3.4,0.0,96.4,8.0,72769,55700,53064,11281,51671,11,90,276,2627,23,73992,6168,19705,53064,11,79,186,2351,25.7,69.1,0.0,0.1,0.2,3.1
E08000031,WOLVERHAMPTON,118013,117701,98.5,92.1,90.4,15.2,89.6,0.0,0.0,0.1,1.3,0.0,98.7,5.0,116205,108669,106661,17885,105770,0,2,77,1496,2,116521,5928,9544,106661,0,2,75,1419,8.1,90.4,0.0,0.0,0.1,1.2
E07000237,WORCESTER,49068,48744,98.4,22.0,11.2,3.7,3.7,0.0,0.0,0.0,0.9,0.0,99.0,0.0,48279,10806,5479,1797,1797,0,0,23,465,16,48559,0,42800,5479,0,0,23,442,87.2,11.2,0.0,0.0,0.0,0.9
E07000229,WORTHING,51837,51752,99.3,94.3,93.9,70.8,70.8,0.0,0.0,0.0,0.6,0.0,99.7,0.0,51457,48885,48685,36726,36726,0,2,8,295,1,51688,0,2772,48685,0,2,6,287,5.3,93.9,0.0,0.0,0.0,0.6
W06000006,WREXHAM,66192,65306,94.6,42.0,41.4,41.0,41.0,0.2,0.8,1.7,4.1,0.9,96.9,43.6,62589,27775,27435,27106,27106,165,553,1103,2717,622,64152,28832,35154,27435,165,388,550,1614,53.1,41.4,0.2,0.6,0.8,2.4
E07000238,WYCHAVON,63359,62695,94.2,23.8,20.0,12.8,17.5,0.2,0.7,1.2,4.7,0.3,98.4,0.0,59690,15064,12656,8099,11101,105,467,760,3005,202,62333,1,47034,12656,105,362,293,2245,74.2,20.0,0.2,0.6,0.5,3.5
E07000128,WYRE,57413,57099,95.4,46.4,46.4,46.3,46.3,0.1,0.2,0.6,4.1,0.0,98.4,10.7,54757,26622,26617,26591,26591,46,140,361,2342,23,56517,6146,28140,26617,46,94,221,1981,49.0,46.4,0.1,0.2,0.4,3.5
E07000239,WYRE FOREST,48472,48204,96.7,48.5,48.1,2.6,48.1,0.1,0.3,0.7,2.8,0.2,99.1,3.4,46859,23514,23324,1276,23324,45,141,323,1345,94,48058,1662,23535,23324,45,96,182,1022,48.6,48.1,0.1,0.2,0.4,2.1
E06000014,YORK,96147,95638,94.2,77.5,74.5,60.4,72.0,0.0,0.2,0.7,5.2,0.0,96.1,7.1,90609,74466,71630,58026,69189,41,182,668,5029,32,92376,6860,18979,71630,41,141,486,4361,19.7,74.5,0.0,0.1,0.5,4.5
