laua,laua_name,All Premises,All Matched Premises,SFBB availability (% premises),UFBB (100Mbit/s) availability (% premises),UFBB availability (% premises),Full Fibre availability (% premises),Gigabit availability (% premises),% of premises unable to receive 2Mbit/s,% of premises unable to receive 5Mbit/s,% of premises unable to receive 10Mbit/s,% of premises unable to receive 30Mbit/s,% of premises below the USO,% of premises with NGA,% of premises able to receive decent broadband from FWA,Number of premises with SFBB availability,Number of premises with UFBB (100Mbit/s) availability,Number of premises with UFBB availability,Number of premises with Full Fibre availability,Number of premises with Gigabit availability,Number of premises unable to receive 2Mbit/s,Number of premises unable to receive 5Mbit/s,Number of premises unable to receive 10Mbit/s,Number of premises unable to receive 30Mbit/s,Number of premises below the USO,Number of premises with NGA,Number of premises able to receive decent broadband from FWA,Number of premises with 30<300Mbit/s download speed,Number of premises with >=300Mbit/s download speed,Number of premises with 0<2Mbit/s download speed,Number of premises with 2<5Mbit/s download speed,Number of premises with 5<10Mbit/s download speed,Number of premises with 10<30Mbit/s download speed,% of premises with 30<300Mbit/s download speed,% of premises with >=300Mbit/s download speed,% of premises with 0<2Mbit/s download speed,% of premises with 2<5Mbit/s download speed,% of premises with 5<10Mbit/s download speed,% of premises with 10<30Mbit/s download speed
S12000033,ABERDEEN CITY,128708,128294,95.8,79.1,77.1,74.4,74.4,0.0,0.1,0.4,3.9,0.0,97.1,0.0,123335,101776,99197,95719,95719,59,178,548,4959,55,125036,0,24138,99197,59,119,370,4411,18.8,77.1,0.0,0.1,0.3,3.4
S12000034,ABERDEENSHIRE,127941,127265,84.2,20.6,20.5,20.5,20.5,1.8,4.5,8.2,15.3,2.6,94.8,0.0,107742,26341,26251,26171,26171,2330,5780,10440,19523,3335,121312,0,81491,26251,2330,3450,4660,9083,63.7,20.5,1.8,2.7,3.6,7.1
E07000223,ADUR,29971,29920,99.1,91.0,91.0,54.5,90.1,0.0,0.0,0.2,0.8,0.0,99.5,0.0,29687,27264,27264,16333,27009,2,8,47,233,7,29826,0,2423,27264,2,6,39,186,8.1,91.0,0.0,0.0,0.1,0.6
E07000026,ALLERDALE,52309,52133,92.7,5.4,5.4,5.4,5.4,1.2,2.1,2.9,6.9,0.6,98.6,3.4,48499,2811,2811,2811,2811,630,1086,1541,3634,327,51583,1788,45688,2811,630,456,455,2093,87.3,5.4,1.2,0.9,0.9,4.0
E07000032,AMBER VALLEY,62170,61902,96.1,49.4,46.2,43.6,43.7,0.1,0.3,0.5,3.4,0.2,99.2,0.0,59760,30682,28732,27101,27186,58,161,287,2142,107,61669,0,31028,28732,58,103,126,1855,49.9,46.2,0.1,0.2,0.2,3.0
S12000041,ANGUS,61825,61621,87.9,31.5,31.4,19.6,31.3,1.1,2.8,5.8,11.7,1.6,95.7,0.0,54368,19497,19442,12094,19381,666,1759,3570,7253,977,59147,0,34926,19442,666,1093,1811,3683,56.5,31.4,1.1,1.8,2.9,6.0
N09000001,ANTRIM AND NEWTOWNABBEY,65585,64980,92.6,86.4,86.4,84.7,86.4,1.5,2.7,3.3,6.4,0.8,98.9,0.0,60751,56686,56663,55576,56644,998,1784,2171,4229,553,64853,0,4088,56663,998,786,387,2058,6.2,86.4,1.5,1.2,0.6,3.1
N09000011,ARDS AND NORTH DOWN,78648,78436,95.5,88.4,88.4,87.8,88.4,0.5,1.1,1.9,4.3,0.5,99.7,0.0,75072,69552,69552,69070,69542,426,852,1487,3364,393,78374,1,5520,69552,426,426,635,1877,7.0,88.4,0.5,0.5,0.8,2.4
S12000035,ARGYLL AND BUTE,57002,56097,80.6,4.0,4.0,4.0,4.0,2.8,5.0,8.8,17.8,4.8,89.8,0.0,45937,2289,2289,2288,2289,1621,2843,5022,10160,2747,51175,0,43648,2289,1621,1222,2179,5138,76.6,4.0,2.8,2.1,3.8,9.0
N09000002,"ARMAGH CITY, BANBRIDGE AND CRAIGAVON",94483,94246,93.8,83.2,83.2,83.2,83.2,0.7,1.5,2.2,6.0,0.8,99.1,0.0,88617,78595,78595,78595,78595,655,1431,2109,5629,749,93626,0,10022,78595,655,776,678,3520,10.6,83.2,0.7,0.8,0.7,3.7
E07000224,ARUN,80249,80010,97.0,33.7,30.3,28.1,28.2,0.0,0.1,0.2,2.7,0.1,99.7,0.0,77848,27063,24306,22542,22615,26,62,150,2162,81,79972,0,53542,24306,26,36,88,2012,66.7,30.3,0.0,0.0,0.1,2.5
E07000170,ASHFIELD,59770,59627,98.2,89.5,89.5,25.0,88.4,0.0,0.3,0.5,1.6,0.0,99.0,0.0,58698,53520,53474,14939,52822,12,204,285,929,19,59147,1,5224,53474,12,192,81,644,8.7,89.5,0.0,0.3,0.1,1.1
E07000105,ASHFORD,60350,60147,92.3,65.6,63.7,40.6,62.7,0.3,1.1,2.3,7.4,0.4,98.4,34.9,55688,39575,38463,24521,37837,177,647,1418,4459,261,59408,21064,17225,38463,177,470,771,3041,28.5,63.7,0.3,0.8,1.3,5.0
E07000200,BABERGH,44457,44259,95.0,23.3,23.2,21.8,23.2,0.3,0.7,1.0,4.6,0.3,99.1,19.2,42215,10368,10307,9713,10294,134,299,447,2044,125,44036,8535,31908,10307,134,165,148,1597,71.8,23.2,0.3,0.4,0.3,3.6
E09000002,BARKING AND DAGENHAM,81509,81136,98.2,90.7,90.7,56.1,89.1,0.0,0.6,0.8,1.4,0.4,98.2,0.0,80011,73945,73938,45727,72664,34,472,654,1125,308,80021,0,6073,73938,34,438,182,471,7.5,90.7,0.0,0.5,0.2,0.6
E09000003,BARNET,162590,162172,97.8,68.5,66.1,33.6,63.7,0.0,0.0,0.1,2.0,0.0,98.5,0.0,158983,111376,107470,54644,103632,0,15,160,3189,7,160231,0,51513,107470,0,15,145,3029,31.7,66.1,0.0,0.0,0.1,1.9
E08000016,BARNSLEY,119116,118924,98.4,71.3,68.7,27.2,28.7,0.1,0.2,0.3,1.4,0.0,99.2,19.7,117249,84982,81783,32377,34221,74,222,390,1675,11,118170,23478,35466,81783,74,148,168,1285,29.8,68.7,0.1,0.1,0.1,1.1
E07000027,BARROW-IN-FURNESS,35864,35812,98.8,51.0,51.0,51.0,51.0,0.1,0.2,0.3,1.1,0.1,99.8,0.3,35431,18291,18291,18291,18291,53,79,116,381,22,35803,100,17140,18291,53,26,37,265,47.8,51.0,0.1,0.1,0.1,0.7
E07000066,BASILDON,84302,84146,98.3,86.3,85.7,48.1,75.5,0.0,0.2,0.5,1.5,0.0,99.2,0.0,82903,72731,72264,40542,63652,15,167,413,1243,28,83629,0,10639,72264,15,152,246,830,12.6,85.7,0.0,0.2,0.3,1.0
E07000084,BASINGSTOKE AND DEANE,83242,83068,96.3,65.7,64.6,42.8,63.9,0.2,0.5,1.0,3.5,0.2,98.7,0.0,80121,54715,53794,35608,53156,140,431,837,2947,207,82124,0,26327,53794,140,291,406,2110,31.6,64.6,0.2,0.3,0.5,2.5
E07000171,BASSETLAW,58634,58260,95.9,39.3,37.6,14.9,36.2,0.4,0.7,1.1,3.5,0.2,98.8,20.9,56211,23070,22024,8741,21226,214,395,671,2049,125,57919,12237,34187,22024,214,181,276,1378,58.3,37.6,0.4,0.3,0.5,2.4
E06000022,BATH AND NORTH EAST SOMERSET,89547,89242,94.1,68.8,63.4,40.0,58.9,0.1,0.2,0.6,5.5,0.1,96.2,0.0,84297,61596,56736,35807,52733,71,207,493,4945,115,86157,0,27561,56736,71,136,286,4452,30.8,63.4,0.1,0.2,0.3,5.0
E06000055,BEDFORD,83131,82989,97.3,79.3,77.3,34.1,74.6,0.1,0.4,0.7,2.5,0.1,98.9,0.0,80871,65914,64278,28364,62034,111,301,585,2118,62,82253,1,16593,64278,111,190,284,1533,20.0,77.3,0.1,0.2,0.3,1.8
N09000003,BELFAST,173905,172813,98.4,94.6,94.6,87.8,94.4,0.0,0.1,0.2,1.0,0.1,98.5,0.0,171140,164483,164481,152765,164108,24,140,399,1673,119,171337,1,6659,164481,24,116,259,1274,3.8,94.6,0.0,0.1,0.1,0.7
E09000004,BEXLEY,104275,104092,98.2,87.4,87.0,62.1,86.1,0.0,0.1,0.5,1.6,0.0,98.5,0.0,102413,91085,90730,64751,89821,3,115,549,1679,7,102691,0,11683,90730,3,112,434,1130,11.2,87.0,0.0,0.1,0.4,1.1
E08000025,BIRMINGHAM,477617,475094,95.8,90.9,90.3,42.9,88.9,0.0,0.2,0.7,3.6,0.0,95.9,0.0,457684,434071,431406,204861,424717,36,747,3202,17410,89,458007,43,26278,431406,36,711,2455,14208,5.5,90.3,0.0,0.1,0.5,3.0
E07000129,BLABY,45901,45816,98.0,75.4,73.7,39.2,72.3,0.1,0.2,0.4,1.9,0.0,98.9,0.0,44965,34617,33814,18006,33176,30,97,175,851,4,45403,0,11151,33814,30,67,78,676,24.3,73.7,0.1,0.1,0.2,1.5
E06000008,BLACKBURN WITH DARWEN,68180,67865,97.4,70.2,70.0,14.2,69.6,0.0,0.2,0.3,2.1,0.0,98.8,69.4,66413,47841,47710,9715,47462,27,137,238,1452,22,67390,47298,18703,47710,27,110,101,1214,27.4,70.0,0.0,0.2,0.1,1.8
E06000009,BLACKPOOL,78182,77712,98.1,71.6,71.6,3.9,71.5,0.0,0.0,0.0,1.3,0.0,98.3,9.1,76727,56011,55968,3066,55931,8,21,34,985,2,76848,7124,20759,55968,8,13,13,951,26.6,71.6,0.0,0.0,0.0,1.2
W06000019,BLAENAU GWENT,35486,35382,96.5,9.1,7.7,6.6,6.6,0.1,0.2,0.6,3.2,0.1,99.3,0.0,34236,3227,2718,2336,2336,24,88,215,1146,44,35242,17,31518,2718,24,64,127,931,88.8,7.7,0.1,0.2,0.4,2.6
E07000033,BOLSOVER,39731,39585,95.3,45.7,41.8,19.5,39.8,0.1,0.2,0.6,4.4,0.1,98.7,0.0,37848,18175,16609,7765,15808,41,66,223,1737,46,39201,0,21239,16609,41,25,157,1514,53.5,41.8,0.1,0.1,0.4,3.8
E08000001,BOLTON,134292,133962,98.4,89.7,88.4,27.9,86.6,0.0,0.1,0.2,1.4,0.0,99.2,3.4,132137,120497,118781,37530,116315,23,122,316,1825,11,133183,4623,13356,118781,23,99,194,1509,9.9,88.4,0.0,0.1,0.1,1.1
E07000136,BOSTON,33864,33526,93.2,59.1,59.1,59.1,59.1,0.5,1.3,2.0,5.8,0.6,98.0,17.0,31558,20000,20000,20000,20000,168,434,680,1968,207,33183,5750,11558,20000,168,266,246,1288,34.1,59.1,0.5,0.8,0.7,3.8
E06000058,"BOURNEMOUTH, CHRISTCHURCH AND POOLE",199440,198746,98.5,84.3,82.4,43.3,80.7,0.2,0.2,0.2,1.2,0.0,99.2,0.2,196374,168157,164393,86353,161018,318,357,472,2372,36,197906,302,31981,164393,318,39,115,1900,16.0,82.4,0.2,0.0,0.1,1.0
E06000036,BRACKNELL FOREST,55741,55574,97.2,86.1,84.3,53.7,82.7,0.0,0.1,0.2,2.5,0.0,97.8,0.0,54161,47984,47005,29917,46125,8,48,103,1413,8,54529,3,7156,47005,8,40,55,1310,12.8,84.3,0.0,0.1,0.1,2.4
E08000032,BRADFORD,224446,223580,97.1,86.6,85.0,35.0,83.4,0.1,0.2,0.4,2.5,0.0,98.2,55.6,217869,194478,190888,78637,187158,144,446,842,5711,6,220426,124830,26981,190888,144,302,396,4869,12.0,85.0,0.1,0.1,0.2,2.2
E07000067,BRAINTREE,72847,72524,96.8,48.6,48.6,48.6,48.6,0.2,0.4,0.8,2.7,0.1,98.2,35.2,70539,35440,35440,35406,35440,140,304,570,1985,61,71568,25620,35099,35440,140,164,266,1415,48.2,48.6,0.2,0.2,0.4,1.9
E07000143,BRECKLAND,67545,67307,92.4,42.1,40.7,39.8,39.8,0.6,1.4,2.3,7.3,1.3,98.3,0.1,62402,28463,27524,26856,26856,434,946,1571,4905,845,66409,37,34878,27524,434,512,625,3334,51.6,40.7,0.6,0.8,0.9,4.9
E09000005,BRENT,142001,139316,96.0,80.6,78.8,53.2,76.7,0.0,0.1,0.3,2.1,0.0,96.1,0.0,136297,114407,111843,75538,108975,0,92,437,3019,34,136402,0,24454,111843,0,92,345,2582,17.2,78.8,0.0,0.1,0.2,1.8
E07000068,BRENTWOOD,36248,36118,95.7,52.5,52.5,52.5,52.5,0.1,0.2,0.5,3.9,0.1,97.9,0.8,34694,19031,19031,19029,19030,36,69,185,1424,27,35474,278,15663,19031,36,33,116,1239,43.2,52.5,0.1,0.1,0.3,3.4
W06000013,BRIDGEND,68011,67892,97.5,51.7,45.4,40.7,40.8,0.0,0.2,0.4,2.3,0.0,99.2,36.1,66296,35189,30884,27697,27722,32,112,275,1596,18,67472,24552,35412,30884,32,80,163,1321,52.1,45.4,0.0,0.1,0.2,1.9
E06000043,BRIGHTON AND HOVE,143066,141450,96.9,85.0,82.2,29.5,77.7,0.0,0.1,0.6,2.0,0.0,97.1,0.0,138565,121676,117541,42170,111114,22,121,820,2885,19,138877,0,21024,117541,22,99,699,2065,14.7,82.2,0.0,0.1,0.5,1.4
E06000023,"BRISTOL, CITY OF",213986,213065,96.1,91.4,91.3,59.2,90.0,0.0,0.1,0.7,3.5,0.0,96.2,0.0,205572,195551,195353,126605,192592,18,156,1505,7493,62,205870,0,10219,195353,18,138,1349,5988,4.8,91.3,0.0,0.1,0.6,2.8
E07000144,BROADLAND,62359,62214,95.3,50.8,49.3,23.3,48.5,0.2,0.4,1.1,4.4,0.7,99.0,0.1,59442,31663,30755,14514,30255,117,257,714,2772,450,61721,35,28687,30755,117,140,457,2058,46.0,49.3,0.2,0.2,0.7,3.3
E09000006,BROMLEY,147189,147025,98.4,90.5,90.3,38.1,88.9,0.0,0.1,0.2,1.5,0.0,98.9,0.0,144837,133211,132863,56035,130848,30,146,360,2188,26,145641,0,11974,132863,30,116,214,1828,8.1,90.3,0.0,0.1,0.1,1.2
E07000234,BROMSGROVE,45371,44981,97.2,76.6,76.6,56.6,76.4,0.0,0.2,0.4,2.0,0.2,98.8,0.1,44096,34749,34749,25671,34669,18,88,169,885,96,44828,41,9347,34749,18,70,81,716,20.6,76.6,0.0,0.2,0.2,1.6
E07000095,BROXBOURNE,43388,43329,98.6,88.6,85.9,7.3,81.0,0.1,0.1,0.2,1.3,0.0,99.3,0.0,42785,38435,37263,3162,35130,28,38,87,544,5,43074,0,5522,37263,28,10,49,457,12.7,85.9,0.1,0.0,0.1,1.1
E07000172,BROXTOWE,52682,52622,99.2,94.0,93.5,55.2,92.1,0.0,0.1,0.1,0.7,0.0,99.6,0.0,52238,49499,49276,29075,48500,11,31,72,384,4,52496,0,2962,49276,11,20,41,312,5.6,93.5,0.0,0.0,0.1,0.6
E06000060,BUCKINGHAMSHIRE,243854,242991,96.0,68.7,65.2,40.4,62.5,0.1,0.4,0.9,3.6,0.2,98.4,0.1,234185,167569,159074,98572,152515,282,1008,2262,8806,422,240058,332,75111,159074,282,726,1254,6544,30.8,65.2,0.1,0.3,0.5,2.7
E07000117,BURNLEY,45852,45723,97.9,80.6,80.6,12.1,80.6,0.0,0.1,0.3,1.8,0.0,99.3,61.1,44898,36945,36945,5532,36934,21,52,124,825,14,45509,28000,7953,36945,21,31,72,701,17.3,80.6,0.0,0.1,0.2,1.5
E08000002,BURY,90140,89848,98.6,82.4,79.0,68.9,74.9,0.0,0.1,0.1,1.0,0.0,99.6,0.0,88902,74237,71226,62084,67511,10,85,133,946,9,89778,0,17676,71226,10,75,48,813,19.6,79.0,0.0,0.1,0.1,0.9
W06000018,CAERPHILLY,83813,83555,98.5,42.9,40.4,38.6,38.6,0.0,0.1,0.2,1.2,0.0,99.6,46.6,82573,35954,33882,32365,32389,24,76,141,982,20,83436,39064,48691,33882,24,52,65,841,58.1,40.4,0.0,0.1,0.1,1.0
E08000033,CALDERDALE,104074,103884,95.1,52.9,52.8,15.3,52.7,0.1,0.4,0.6,4.7,0.0,98.5,43.0,99018,55067,54979,15950,54854,127,374,624,4866,45,102539,44741,44039,54979,127,247,250,4242,42.3,52.8,0.1,0.2,0.2,4.1
E07000008,CAMBRIDGE,60695,60527,98.6,93.4,92.2,61.9,90.5,0.0,0.0,0.1,1.2,0.0,98.7,0.0,59819,56704,55955,37548,54935,1,24,89,708,2,59889,0,3864,55955,1,23,65,619,6.4,92.2,0.0,0.0,0.1,1.0
E09000007,CAMDEN,123038,122276,97.2,92.8,92.6,70.0,91.4,0.0,0.0,0.0,2.2,0.0,97.3,0.0,119580,114130,113966,86080,112433,0,0,15,2696,3,119659,3,5614,113966,0,0,15,2681,4.6,92.6,0.0,0.0,0.0,2.2
E07000192,CANNOCK CHASE,48834,48592,98.3,81.1,81.0,60.7,80.9,0.0,0.1,0.2,1.2,0.1,99.3,0.0,48016,39617,39576,29660,39509,17,42,106,576,36,48511,0,8440,39576,17,25,64,470,17.3,81.0,0.0,0.1,0.1,1.0
E07000106,CANTERBURY,74492,72246,92.5,42.8,42.8,42.8,42.8,0.2,0.5,0.9,4.5,0.2,96.7,14.7,68881,31875,31874,31875,31875,132,368,700,3365,128,72000,10927,37007,31874,132,236,332,2665,49.7,42.8,0.2,0.3,0.4,3.6
W06000015,CARDIFF,168105,167371,97.8,88.7,87.2,60.0,85.7,0.0,0.2,0.5,1.7,0.0,98.3,61.3,164450,149166,146556,100813,144030,28,321,884,2921,16,165173,103016,17894,146556,28,293,563,2037,10.6,87.2,0.0,0.2,0.3,1.2
E07000028,CARLISLE,58303,58072,94.5,56.2,49.9,9.7,45.9,0.6,1.5,2.4,5.1,0.8,98.0,1.6,55100,32751,29111,5633,26767,373,860,1417,2972,457,57148,909,25989,29111,373,487,557,1555,44.6,49.9,0.6,0.8,1.0,2.7
W06000010,CARMARTHENSHIRE,94150,93320,89.3,45.9,45.9,46.0,46.0,1.3,3.0,4.9,9.8,1.5,94.5,1.7,84106,43254,43254,43310,43312,1245,2803,4630,9214,1408,88999,1617,40852,43254,1245,1558,1827,4584,43.4,45.9,1.3,1.7,1.9,4.9
E07000069,CASTLE POINT,41449,40990,98.0,44.3,44.3,3.6,41.0,0.0,0.1,0.2,0.9,0.3,98.5,0.0,40627,18369,18369,1509,17014,11,57,76,363,139,40841,0,22258,18369,11,46,19,287,53.7,44.3,0.0,0.1,0.0,0.7
N09000004,CAUSEWAY COAST AND GLENS,71093,69769,92.5,82.4,82.4,82.4,82.4,1.1,1.9,2.6,5.6,1.1,97.7,0.1,65772,58558,58558,58556,58557,787,1359,1855,3997,769,69479,37,7214,58558,787,572,496,2142,10.1,82.4,1.1,0.8,0.7,3.0
E06000056,CENTRAL BEDFORDSHIRE,136126,133067,95.1,74.5,72.6,28.5,71.1,0.1,0.4,0.8,2.6,0.1,97.0,0.1,129465,101347,98789,38773,96825,130,590,1055,3602,148,132035,119,30676,98789,130,460,465,2547,22.5,72.6,0.1,0.3,0.3,1.9
W06000008,CEREDIGION,37983,37626,85.7,27.3,27.3,27.3,27.3,1.7,4.4,7.7,13.3,2.4,92.2,6.3,32560,10367,10367,10367,10367,645,1679,2916,5066,906,35033,2411,22193,10367,645,1034,1237,2150,58.4,27.3,1.7,2.7,3.3,5.7
E07000130,CHARNWOOD,80533,80345,98.5,78.0,75.1,19.2,72.9,0.1,0.2,0.4,1.3,0.1,99.4,0.0,79329,62788,60486,15492,58707,106,201,329,1016,60,80075,0,18843,60486,106,95,128,687,23.4,75.1,0.1,0.1,0.2,0.9
E07000070,CHELMSFORD,83457,83203,96.1,67.7,65.4,48.0,63.0,0.1,0.2,0.7,3.6,0.1,98.4,1.5,80192,56542,54574,40088,52556,55,183,576,3011,43,82138,1244,25618,54574,55,128,393,2435,30.7,65.4,0.1,0.2,0.5,2.9
E07000078,CHELTENHAM,60441,60296,98.9,82.1,77.4,35.3,73.1,0.0,0.1,0.3,0.8,0.0,99.2,0.0,59790,49605,46790,21354,44201,6,80,153,506,9,59935,0,13000,46790,6,74,73,353,21.5,77.4,0.0,0.1,0.1,0.6
E07000177,CHERWELL,73577,73214,97.0,65.7,60.1,35.5,56.0,0.3,0.6,0.9,2.5,0.1,98.4,0.7,71373,48318,44203,26131,41170,214,428,661,1841,90,72429,482,27170,44203,214,214,233,1180,36.9,60.1,0.3,0.3,0.3,1.6
E06000049,CHESHIRE EAST,194761,194117,94.8,61.6,56.7,31.7,53.9,0.2,0.7,1.3,4.9,0.2,98.5,3.9,184606,119896,110524,61806,104959,421,1291,2458,9511,455,191799,7617,74082,110524,421,870,1167,7053,38.0,56.7,0.2,0.4,0.6,3.6
E06000050,CHESHIRE WEST AND CHESTER,172019,171641,96.0,68.1,63.0,56.0,59.7,0.1,0.5,1.0,3.8,0.1,99.0,0.5,165122,117219,108302,96298,102749,251,866,1647,6519,239,170339,778,56820,108302,251,615,781,4872,33.0,63.0,0.1,0.4,0.5,2.8
E07000034,CHESTERFIELD,54116,53941,97.2,56.3,56.3,25.6,56.2,0.0,0.0,0.2,2.5,0.0,99.0,0.0,52596,30486,30486,13847,30430,0,7,97,1345,8,53590,0,22110,30486,0,7,90,1248,40.9,56.3,0.0,0.0,0.2,2.3
E07000225,CHICHESTER,63259,62822,92.2,33.7,31.8,30.4,30.5,0.3,0.8,1.7,7.1,0.7,98.8,0.0,58347,21329,20144,19248,19269,187,475,1049,4475,414,62483,0,38203,20144,187,288,574,3426,60.4,31.8,0.3,0.5,0.9,5.4
E07000118,CHORLEY,55490,55360,96.7,74.5,72.5,49.4,70.7,0.0,0.2,0.5,3.0,0.0,99.2,35.0,53669,41355,40255,27395,39231,9,113,294,1691,14,55045,19421,13414,40255,9,104,181,1397,24.2,72.5,0.0,0.2,0.3,2.5
S12000036,CITY OF EDINBURGH,280952,280393,97.6,90.4,89.2,66.5,87.9,0.0,0.1,0.4,2.2,0.0,98.0,0.0,274286,253867,250707,186801,246993,105,381,1145,6107,31,275244,4,23579,250707,105,276,764,4962,8.4,89.2,0.0,0.1,0.3,1.8
E09000001,CITY OF LONDON,10932,10711,58.7,50.6,50.6,49.1,49.9,0.0,0.0,0.0,39.3,0.0,58.7,0.0,6417,5533,5533,5369,5450,0,0,0,4294,2,6417,1,884,5533,0,0,0,4294,8.1,50.6,0.0,0.0,0.0,39.3
S12000005,CLACKMANNANSHIRE,26637,26595,98.4,65.1,59.1,56.7,56.7,0.1,0.2,0.4,1.5,0.1,99.7,0.0,26207,17329,15746,15110,15110,25,52,98,388,36,26563,0,10461,15746,25,27,46,290,39.3,59.1,0.1,0.1,0.2,1.1
E07000071,COLCHESTER,89215,88261,96.2,66.3,66.2,22.8,66.2,0.1,0.5,0.9,2.7,0.3,97.6,43.9,85864,59121,59065,20297,59045,92,452,799,2397,241,87096,39132,26799,59065,92,360,347,1598,30.0,66.2,0.1,0.4,0.4,1.8
W06000003,CONWY,59918,59697,95.0,40.4,40.4,40.4,40.4,0.6,1.4,2.4,4.6,0.9,97.6,57.8,56938,24196,24196,24197,24197,368,825,1455,2759,520,58508,34620,32742,24196,368,457,630,1304,54.6,40.4,0.6,0.8,1.1,2.2
E07000029,COPELAND,35997,35893,95.0,2.7,2.7,2.7,2.7,0.3,0.7,1.2,4.7,0.9,99.0,0.0,34184,957,957,957,957,100,237,448,1709,326,35650,0,33227,957,100,137,211,1261,92.3,2.7,0.3,0.4,0.6,3.5
E06000052,CORNWALL,305041,302951,88.6,44.2,43.1,40.3,42.4,0.3,0.9,2.0,10.7,0.5,93.7,12.8,270393,134955,131442,123069,129259,839,2661,6124,32558,1417,285678,39017,138951,131442,839,1822,3463,26434,45.6,43.1,0.3,0.6,1.1,8.7
E07000079,COTSWOLD,48203,48004,94.9,46.9,46.7,46.6,46.6,0.1,0.4,1.1,4.7,0.3,96.5,0.4,45741,22586,22522,22458,22459,54,208,519,2263,131,46509,202,23219,22522,54,154,311,1744,48.2,46.7,0.1,0.3,0.6,3.6
E06000047,COUNTY DURHAM,263216,262474,95.3,53.1,51.2,48.3,49.9,0.3,0.7,1.2,4.5,0.2,99.0,0.7,250753,139677,134815,127260,131397,816,1875,3061,11721,572,260598,1794,115938,134815,816,1059,1186,8660,44.0,51.2,0.3,0.4,0.5,3.3
E08000026,COVENTRY,150692,150311,98.6,96.7,96.7,94.9,96.7,0.0,0.2,0.5,1.1,0.0,98.7,0.0,148586,145791,145789,143026,145656,2,279,716,1725,21,148668,0,2797,145789,2,277,437,1009,1.9,96.7,0.0,0.2,0.3,0.7
E07000163,CRAVEN,30719,30548,93.8,36.1,32.6,30.3,30.3,0.8,1.3,2.2,5.6,0.5,98.0,45.1,28817,11090,10024,9296,9308,249,402,677,1731,142,30093,13839,18793,10024,249,153,275,1054,61.2,32.6,0.8,0.5,0.9,3.4
E07000226,CRAWLEY,50128,49877,98.5,87.2,87.2,25.4,86.6,0.0,0.1,0.2,1.0,0.4,98.9,0.0,49380,43720,43720,12731,43410,21,44,111,497,190,49591,0,5660,43720,21,23,67,386,11.3,87.2,0.0,0.0,0.1,0.8
E09000008,CROYDON,170907,170415,96.3,86.3,86.3,43.8,84.5,0.0,0.0,0.3,3.4,0.0,96.8,0.0,164641,147546,147543,74904,144331,4,73,435,5774,17,165479,0,17098,147543,4,69,362,5339,10.0,86.3,0.0,0.0,0.2,3.1
E07000096,DACORUM,69810,69560,96.9,80.8,79.2,43.5,78.0,0.1,0.3,0.5,2.7,0.1,98.9,0.0,67666,56380,55267,30347,54480,44,236,367,1894,58,69042,0,12399,55267,44,192,131,1527,17.8,79.2,0.1,0.3,0.2,2.2
E06000005,DARLINGTON,55716,55498,95.7,86.1,85.8,18.9,85.5,0.7,1.6,2.3,4.0,0.4,97.0,10.0,53296,47970,47822,10535,47663,385,907,1293,2202,218,54019,5588,5474,47822,385,522,386,909,9.8,85.8,0.7,0.9,0.7,1.6
E07000107,DARTFORD,50732,50686,97.3,76.0,74.6,41.4,73.1,0.1,0.3,0.6,2.6,0.0,98.7,0.0,49385,38560,37829,20996,37073,38,176,327,1301,7,50061,0,11556,37829,38,138,151,974,22.8,74.6,0.1,0.3,0.3,1.9
W06000004,DENBIGHSHIRE,50290,50026,92.8,62.2,62.2,62.2,62.2,0.7,1.7,3.0,6.7,0.6,96.0,30.2,46664,31269,31269,31271,31271,328,841,1485,3362,299,48259,15179,15395,31269,328,513,644,1877,30.6,62.2,0.7,1.0,1.3,3.7
E06000015,DERBY,120394,119701,98.8,95.2,94.8,67.1,94.4,0.0,0.0,0.1,0.6,0.0,98.9,0.0,118935,114667,114112,80834,113616,1,37,164,766,20,119056,0,4823,114112,1,36,127,602,4.0,94.8,0.0,0.0,0.1,0.5
E07000035,DERBYSHIRE DALES,38146,37920,90.5,14.4,14.4,14.4,14.4,0.5,1.3,2.9,8.9,0.9,96.7,0.0,34517,5484,5484,5484,5484,190,504,1100,3403,330,36893,0,29033,5484,190,314,596,2303,76.1,14.4,0.5,0.8,1.6,6.0
N09000005,DERRY CITY AND STRABANE,67742,67557,94.1,87.1,87.1,84.9,87.1,1.4,2.2,2.9,5.6,1.5,99.1,0.1,63760,59037,59037,57501,59031,948,1462,1947,3797,1042,67109,78,4723,59037,948,514,485,1850,7.0,87.1,1.4,0.8,0.7,2.7
E08000017,DONCASTER,148972,148627,98.1,67.9,67.8,55.6,66.9,0.1,0.2,0.5,1.6,0.0,99.0,12.8,146200,101131,100969,82885,99696,103,310,723,2427,63,147482,19033,45231,100969,103,207,413,1704,30.4,67.8,0.1,0.1,0.3,1.1
E06000059,DORSET,192249,191348,94.7,36.8,36.7,34.8,36.6,0.1,0.4,0.9,4.8,0.2,98.7,3.0,182073,70795,70647,66994,70427,231,829,1656,9275,445,189705,5757,111426,70647,231,598,827,7619,58.0,36.7,0.1,0.3,0.4,4.0
E07000108,DOVER,56596,56440,94.5,61.7,61.7,35.9,61.7,0.3,0.7,1.3,5.2,0.1,98.5,32.9,53476,34930,34930,20346,34928,195,379,709,2964,84,55723,18593,18546,34930,195,184,330,2255,32.8,61.7,0.3,0.3,0.6,4.0
E08000027,DUDLEY,148091,147757,99.0,91.7,90.7,7.5,88.8,0.0,0.0,0.0,0.8,0.0,99.4,4.4,146558,135726,134301,11052,131518,0,14,63,1199,16,147175,6475,12257,134301,0,14,49,1136,8.3,90.7,0.0,0.0,0.0,0.8
S12000006,DUMFRIES AND GALLOWAY,82995,82582,88.0,18.8,18.8,18.8,18.8,1.3,3.0,5.5,11.5,2.1,96.8,0.0,73016,15618,15618,15617,15617,1120,2507,4542,9566,1712,80348,10,57398,15618,1120,1387,2035,5024,69.2,18.8,1.3,1.7,2.5,6.1
S12000042,DUNDEE CITY,80347,80265,98.8,93.8,92.5,57.1,91.3,0.0,0.0,0.1,1.1,0.0,99.2,0.0,79385,75388,74294,45888,73359,2,11,95,880,2,79737,0,5091,74294,2,9,84,785,6.3,92.5,0.0,0.0,0.1,1.0
E09000009,EALING,153205,152635,98.4,85.2,84.8,30.9,83.6,0.0,0.0,0.4,1.2,0.0,98.4,0.0,150733,130513,129975,47327,128128,1,68,681,1902,12,150768,0,20758,129975,1,67,613,1221,13.5,84.8,0.0,0.0,0.4,0.8
S12000008,EAST AYRSHIRE,62290,61535,95.3,60.6,60.1,53.2,59.8,0.5,1.0,1.7,3.5,0.3,97.9,0.0,59374,37764,37430,33125,37247,331,623,1031,2161,198,60955,0,21944,37430,331,292,408,1130,35.2,60.1,0.5,0.5,0.7,1.8
E07000009,EAST CAMBRIDGESHIRE,41137,40888,96.3,68.0,65.0,56.7,62.3,0.4,0.7,1.2,3.1,0.2,98.9,1.3,39599,27955,26724,23317,25645,149,278,474,1289,96,40671,536,12875,26724,149,129,196,815,31.3,65.0,0.4,0.3,0.5,2.0
E07000040,EAST DEVON,76769,76494,91.6,57.3,56.7,56.3,56.3,0.3,1.2,2.5,8.1,0.5,96.9,15.2,70295,44018,43518,43227,43257,214,908,1949,6199,347,74381,11679,26777,43518,214,694,1041,4250,34.9,56.7,0.3,0.9,1.4,5.5
S12000045,EAST DUNBARTONSHIRE,50505,50454,96.9,86.2,85.5,28.4,84.7,0.1,0.2,0.6,3.0,0.0,98.8,0.0,48955,43534,43157,14356,42778,48,126,283,1499,14,49923,0,5798,43157,48,78,157,1216,11.5,85.5,0.1,0.2,0.3,2.4
E07000085,EAST HAMPSHIRE,58899,58069,92.8,55.1,53.4,31.5,51.9,0.2,0.5,1.0,5.8,0.3,96.8,0.0,54657,32475,31461,18558,30573,105,286,601,3412,162,57003,0,23196,31461,105,181,315,2811,39.4,53.4,0.2,0.3,0.5,4.8
E07000242,EAST HERTFORDSHIRE,67998,67831,96.2,71.8,69.0,16.1,66.0,0.1,0.3,0.6,3.5,0.2,98.3,0.0,65432,48849,46904,10933,44882,56,186,399,2399,111,66847,3,18528,46904,56,130,213,2000,27.2,69.0,0.1,0.2,0.3,2.9
E07000137,EAST LINDSEY,73823,73422,88.3,27.8,26.3,17.7,25.1,1.0,2.9,4.4,11.2,0.8,97.2,31.3,65163,20547,19441,13065,18509,737,2129,3241,8259,609,71763,23073,45722,19441,737,1392,1112,5018,61.9,26.3,1.0,1.9,1.5,6.8
S12000010,EAST LOTHIAN,50664,50517,93.9,56.7,56.7,56.7,56.7,0.4,1.2,2.0,5.9,0.3,97.8,34.0,47551,28745,28745,28743,28745,192,593,1037,2966,138,49562,17248,18806,28745,192,401,444,1929,37.1,56.7,0.4,0.8,0.9,3.8
S12000011,EAST RENFREWSHIRE,41961,41831,96.4,77.9,77.5,25.2,76.6,0.1,0.2,0.6,3.3,0.1,98.8,0.0,40457,32706,32514,10580,32156,29,64,261,1374,56,41458,0,7943,32514,29,35,197,1113,18.9,77.5,0.1,0.1,0.5,2.7
E06000011,EAST RIDING OF YORKSHIRE,169738,168870,96.9,76.8,76.5,76.3,76.3,0.4,0.7,1.1,2.6,0.2,98.9,35.3,164520,130284,129797,129476,129478,614,1259,1915,4350,277,167798,59919,34723,129797,614,645,656,2435,20.5,76.5,0.4,0.4,0.4,1.4
E07000193,EAST STAFFORDSHIRE,56632,56336,95.4,45.7,42.4,38.4,40.0,0.3,0.7,1.1,4.0,0.2,99.0,0.0,54050,25866,24028,21750,22660,173,404,637,2286,125,56063,0,30022,24028,173,231,233,1649,53.0,42.4,0.3,0.4,0.4,2.9
E07000244,EAST SUFFOLK,128505,127695,95.5,42.1,42.1,36.1,42.1,0.1,0.5,0.9,3.9,0.3,98.5,1.8,122659,54158,54135,46377,54057,166,633,1184,5036,445,126632,2349,68524,54135,166,467,551,3852,53.3,42.1,0.1,0.4,0.4,3.0
E07000061,EASTBOURNE,51306,51235,99.5,54.6,54.6,54.6,54.6,0.0,0.0,0.1,0.4,0.0,99.6,0.0,51043,28009,28009,28009,28009,0,5,42,192,1,51100,0,23034,28009,0,5,37,150,44.9,54.6,0.0,0.0,0.1,0.3
E07000086,EASTLEIGH,62130,62019,97.7,78.8,76.7,23.3,75.4,0.0,0.0,0.2,2.1,0.0,99.0,0.0,60688,48961,47628,14475,46866,0,10,135,1331,2,61530,0,13060,47628,0,10,125,1196,21.0,76.7,0.0,0.0,0.2,1.9
E07000030,EDEN,30521,30364,84.1,36.8,36.8,36.8,36.8,3.7,6.7,8.8,15.3,1.3,96.1,11.1,25682,11241,11241,11241,11241,1139,2036,2684,4682,399,29326,3385,14441,11241,1139,897,648,1998,47.3,36.8,3.7,2.9,2.1,6.5
E07000207,ELMBRIDGE,61690,61565,98.7,82.2,80.0,31.7,78.2,0.0,0.1,0.1,1.1,0.0,99.3,0.0,60878,50733,49342,19534,48213,29,44,73,687,0,61282,0,11536,49342,29,15,29,614,18.7,80.0,0.0,0.0,0.0,1.0
E09000010,ENFIELD,134692,133283,97.0,88.2,87.5,5.1,86.6,0.0,0.2,0.8,1.9,0.0,97.4,0.0,130694,118828,117870,6872,116615,43,258,1120,2589,24,131127,0,12824,117870,43,215,862,1469,9.5,87.5,0.0,0.2,0.6,1.1
E07000072,EPPING FOREST,61724,61541,96.7,85.9,84.6,46.9,83.1,0.1,0.3,0.7,3.0,0.1,97.9,3.2,59689,53030,52220,28953,51282,88,197,431,1852,61,60401,1982,7469,52220,88,109,234,1421,12.1,84.6,0.1,0.2,0.4,2.3
E07000208,EPSOM AND EWELL,33441,33405,99.5,92.1,92.0,72.2,91.0,0.0,0.2,0.2,0.4,0.1,99.6,0.0,33286,30813,30769,24143,30444,0,52,52,119,22,33317,0,2517,30769,0,52,0,67,7.5,92.0,0.0,0.2,0.0,0.2
E07000036,EREWASH,56302,56065,98.0,80.3,78.9,36.6,77.8,0.3,0.3,0.4,1.6,0.0,99.3,0.0,55156,45204,44440,20634,43803,142,191,236,909,6,55921,0,10716,44440,142,49,45,673,19.0,78.9,0.3,0.1,0.1,1.2
E07000041,EXETER,60112,59830,96.6,89.0,89.0,66.8,88.8,0.0,0.1,0.6,2.9,0.0,97.2,33.8,58073,53525,53525,40169,53362,22,67,384,1757,11,58423,20311,4548,53525,22,45,317,1373,7.6,89.0,0.0,0.1,0.5,2.3
S12000014,FALKIRK,75251,75186,97.2,86.9,86.8,13.9,86.2,0.1,0.3,0.8,2.8,0.1,98.7,0.0,73115,65367,65314,10485,64889,52,242,604,2071,97,74296,0,7801,65314,52,190,362,1467,10.4,86.8,0.1,0.3,0.5,1.9
E07000087,FAREHAM,52893,52774,98.2,86.0,83.7,9.2,81.0,0.1,0.2,0.3,1.6,0.0,99.4,0.0,51915,45470,44267,4844,42837,46,89,174,859,3,52551,0,7648,44267,46,43,85,685,14.5,83.7,0.1,0.1,0.2,1.3
E07000010,FENLAND,48788,48592,96.1,65.4,65.3,43.1,55.7,0.2,0.7,1.1,3.5,0.3,98.8,0.0,46886,31921,31882,21041,27191,97,342,522,1706,137,48213,20,15004,31882,97,245,180,1184,30.8,65.3,0.2,0.5,0.4,2.4
N09000006,FERMANAGH AND OMAGH,54531,53875,86.4,71.2,71.2,71.2,71.2,3.9,6.0,7.9,12.4,3.9,98.1,0.1,47099,38799,38799,38799,38799,2133,3291,4290,6776,2122,53513,62,8300,38799,2133,1158,999,2486,15.2,71.2,3.9,2.1,1.8,4.6
S12000047,FIFE,193652,192156,96.0,62.4,62.3,39.0,62.0,0.2,0.7,1.1,3.2,0.2,98.5,0.0,185967,120882,120583,75506,120105,460,1280,2171,6189,334,190803,0,65384,120583,460,820,891,4018,33.8,62.3,0.2,0.4,0.5,2.1
W06000005,FLINTSHIRE,75416,75087,96.0,70.8,66.6,64.2,64.2,0.2,0.9,1.7,3.6,0.2,98.0,38.9,72377,53421,50245,48398,48398,177,642,1258,2710,186,73934,29329,22132,50245,177,465,616,1452,29.3,66.6,0.2,0.6,0.8,1.9
E07000112,FOLKESTONE AND HYTHE,55197,54829,94.1,58.5,58.4,27.5,58.3,0.6,1.2,2.1,5.2,0.1,97.5,12.5,51942,32276,32215,15167,32186,336,637,1139,2887,66,53825,6909,19727,32215,336,301,502,1748,35.7,58.4,0.6,0.5,0.9,3.2
E07000080,FOREST OF DEAN,42210,42013,85.0,40.2,38.3,37.2,37.2,0.3,2.2,5.6,14.5,1.1,90.7,0.7,35885,16954,16179,15685,15686,146,935,2364,6128,456,38303,302,19706,16179,146,789,1429,3764,46.7,38.3,0.3,1.9,3.4,8.9
E07000119,FYLDE,36782,36691,97.6,82.9,81.1,60.2,79.7,0.1,0.3,0.6,2.1,0.0,99.5,19.7,35907,30506,29846,22139,29331,22,105,220,784,2,36584,7248,6061,29846,22,83,115,564,16.5,81.1,0.1,0.2,0.3,1.5
E08000037,GATESHEAD,101782,101338,95.8,72.5,71.6,8.1,70.1,0.0,0.3,1.0,3.8,0.1,97.4,0.0,97519,73827,72841,8264,71387,48,270,978,3819,89,99120,2,24678,72841,48,222,708,2841,24.2,71.6,0.0,0.2,0.7,2.8
E07000173,GEDLING,56023,55916,98.7,91.0,90.7,64.9,90.2,0.0,0.2,0.3,1.1,0.0,99.7,1.5,55283,51003,50835,36360,50533,28,139,164,633,26,55831,841,4448,50835,28,111,25,469,7.9,90.7,0.0,0.2,0.0,0.8
S12000049,GLASGOW CITY,339265,337704,97.2,81.3,77.1,41.9,62.5,0.0,0.0,0.2,2.3,0.0,97.5,0.0,329826,275662,261434,142080,212141,15,94,517,7878,22,330890,0,68392,261434,15,79,423,7361,20.2,77.1,0.0,0.0,0.1,2.2
E07000081,GLOUCESTER,60729,60708,99.0,91.8,91.8,30.9,91.4,0.0,0.2,0.3,1.0,0.0,99.3,0.0,60094,55759,55759,18756,55498,0,131,208,614,4,60308,2,4335,55759,0,131,77,406,7.1,91.8,0.0,0.2,0.1,0.7
E07000088,GOSPORT,39230,39171,99.5,87.5,87.4,5.0,87.3,0.0,0.0,0.0,0.4,0.0,99.8,0.0,39031,34313,34304,1971,34254,4,17,17,140,0,39150,0,4727,34304,4,13,0,123,12.0,87.4,0.0,0.0,0.0,0.3
E07000109,GRAVESHAM,46125,45983,97.1,80.9,77.4,42.9,73.2,0.1,0.3,0.4,2.6,0.1,98.8,0.0,44800,37330,35689,19779,33750,26,125,177,1183,50,45584,0,9111,35689,26,99,52,1006,19.8,77.4,0.1,0.2,0.1,2.2
E07000145,GREAT YARMOUTH,49787,49639,97.9,60.1,60.1,17.1,60.1,0.0,0.1,0.3,1.8,0.1,99.4,0.0,48733,29935,29935,8496,29934,11,59,133,906,45,49493,1,18798,29935,11,48,74,773,37.8,60.1,0.0,0.1,0.1,1.6
E09000011,GREENWICH,126815,126394,98.6,85.4,83.6,45.9,82.2,0.0,0.2,0.3,1.1,0.0,98.7,0.0,124999,108273,106038,58181,104239,1,233,393,1395,3,125123,1,18961,106038,1,232,160,1002,15.0,83.6,0.0,0.2,0.1,0.8
E07000209,GUILDFORD,60048,59913,96.6,74.5,70.7,15.0,67.3,0.0,0.2,0.6,3.2,0.1,99.0,0.0,57980,44757,42451,9019,40399,21,104,337,1933,83,59433,0,15529,42451,21,83,233,1596,25.9,70.7,0.0,0.1,0.4,2.7
W06000002,GWYNEDD,68445,67873,90.7,25.1,23.5,22.6,22.6,0.9,2.2,4.1,8.5,1.4,94.8,17.4,62072,17154,16100,15465,15465,639,1473,2774,5801,925,64859,11931,45972,16100,639,834,1301,3027,67.2,23.5,0.9,1.2,1.9,4.4
E09000012,HACKNEY,128195,126868,96.9,79.4,75.8,37.5,72.6,0.0,0.0,0.3,2.1,0.2,96.9,0.0,124193,101737,97134,48118,93091,0,1,330,2675,239,124244,0,27059,97134,0,1,329,2345,21.1,75.8,0.0,0.0,0.3,1.8
E06000006,HALTON,61798,61621,98.0,70.3,69.8,6.8,68.6,0.0,0.1,0.3,1.7,0.0,99.3,0.0,60562,43419,43111,4206,42380,18,71,167,1059,0,61387,0,17451,43111,18,53,96,892,28.2,69.8,0.0,0.1,0.2,1.4
E07000164,HAMBLETON,45721,45574,91.4,39.1,38.5,38.2,38.2,1.1,2.5,3.8,8.2,0.5,98.2,37.6,41809,17872,17607,17470,17473,513,1132,1743,3765,217,44877,17206,24202,17607,513,619,611,2022,52.9,38.5,1.1,1.4,1.3,4.4
E09000013,HAMMERSMITH AND FULHAM,94432,93403,95.9,85.2,79.3,61.9,72.5,0.0,0.1,0.2,3.0,0.0,95.9,0.0,90541,80497,74854,58435,68464,2,57,159,2862,8,90553,0,15687,74854,2,55,102,2703,16.6,79.3,0.0,0.1,0.1,2.9
E07000131,HARBOROUGH,44759,44654,95.8,53.6,49.0,30.2,46.2,0.2,0.5,1.2,4.0,0.3,98.7,0.0,42870,24002,21938,13499,20685,104,242,547,1784,154,44191,0,20932,21938,104,138,305,1237,46.8,49.0,0.2,0.3,0.7,2.8
E09000014,HARINGEY,111890,111615,98.5,85.6,84.4,6.7,82.8,0.0,0.0,0.2,1.3,0.0,98.5,0.0,110171,95726,94453,7492,92698,0,9,208,1444,5,110264,0,15718,94453,0,9,199,1236,14.0,84.4,0.0,0.0,0.2,1.1
E07000073,HARLOW,42227,42142,97.2,91.9,90.7,10.4,89.3,0.0,0.0,0.8,2.6,0.0,97.5,0.0,41050,38798,38291,4408,37729,1,10,325,1092,2,41158,1,2759,38291,1,9,315,767,6.5,90.7,0.0,0.0,0.7,1.8
E07000165,HARROGATE,80312,80078,94.1,64.1,63.0,45.9,61.9,0.6,1.3,1.8,5.6,0.3,98.3,17.3,75580,51492,50580,36872,49752,479,1031,1475,4498,275,78933,13878,25000,50580,479,552,444,3023,31.1,63.0,0.6,0.7,0.6,3.8
E09000015,HARROW,100472,100087,97.8,81.6,81.6,17.5,79.4,0.0,0.0,0.5,1.8,0.0,97.9,0.0,98275,81990,81990,17572,79746,0,13,453,1812,9,98376,0,16285,81990,0,13,440,1359,16.2,81.6,0.0,0.0,0.4,1.4
E07000089,HART,43566,43445,96.2,71.1,71.1,19.1,71.0,0.1,0.3,0.6,3.6,0.1,99.2,0.0,41897,30974,30974,8325,30926,24,119,241,1548,35,43205,0,10923,30974,24,95,122,1307,25.1,71.1,0.1,0.2,0.3,3.0
E06000001,HARTLEPOOL,47766,47546,96.8,90.1,90.1,9.5,89.8,0.3,0.5,1.0,2.7,0.0,97.5,0.7,46259,43047,43047,4523,42900,149,248,482,1287,18,46550,357,3212,43047,149,99,234,805,6.7,90.1,0.3,0.2,0.5,1.7
E07000062,HASTINGS,46323,46176,99.0,38.1,38.1,38.1,38.1,0.0,0.0,0.1,0.7,0.0,99.7,0.0,45872,17637,17637,17637,17637,0,6,35,304,1,46165,0,28235,17637,0,6,29,269,61.0,38.1,0.0,0.0,0.1,0.6
E07000090,HAVANT,58736,58360,98.6,86.7,86.7,5.1,86.5,0.0,0.1,0.1,0.7,0.0,99.0,0.0,57941,50932,50928,3021,50822,0,48,59,419,4,58156,7,7013,50928,0,48,11,360,11.9,86.7,0.0,0.1,0.0,0.6
E09000016,HAVERING,112600,112483,97.5,85.9,84.4,9.0,80.6,0.1,0.2,0.5,2.4,0.2,98.2,0.0,109729,96703,94999,10126,90730,60,178,609,2754,186,110573,0,14730,94999,60,118,431,2145,13.1,84.4,0.1,0.1,0.4,1.9
E06000019,"HEREFORDSHIRE, COUNTY OF",92234,91850,90.7,53.3,46.8,50.0,50.0,0.7,1.7,3.2,8.9,1.0,96.0,3.1,83653,49132,43156,46104,46104,644,1598,2923,8197,954,88551,2838,40497,43156,644,954,1325,5274,43.9,46.8,0.7,1.0,1.4,5.7
E07000098,HERTSMERE,47295,47244,98.1,84.4,82.5,14.4,79.3,0.0,0.2,0.4,1.8,0.0,98.9,0.0,46411,39924,39019,6823,37512,6,74,184,833,2,46782,0,7392,39019,6,68,110,649,15.6,82.5,0.0,0.1,0.2,1.4
E07000037,HIGH PEAK,46769,46590,93.5,13.1,9.7,6.4,6.4,0.4,0.7,1.2,6.1,0.3,98.7,0.0,43737,6149,4526,2991,2991,186,332,542,2853,141,46161,6,39211,4526,186,146,210,2311,83.8,9.7,0.4,0.3,0.4,4.9
S12000017,HIGHLAND,119740,117035,82.4,30.9,30.9,30.9,30.9,2.1,4.2,7.3,15.3,2.8,92.5,5.0,98725,36976,36976,36976,36976,2526,4976,8690,18310,3295,110779,5951,61749,36976,2526,2450,3714,9620,51.6,30.9,2.1,2.0,3.1,8.0
E09000017,HILLINGDON,121850,121358,97.0,88.7,87.8,36.1,86.5,0.0,0.1,0.6,2.6,0.0,97.2,0.0,118250,108024,106947,43983,105425,25,173,701,3108,12,118498,0,11303,106947,25,148,528,2407,9.3,87.8,0.0,0.1,0.4,2.0
E07000132,HINCKLEY AND BOSWORTH,55427,54943,97.3,67.6,65.1,17.0,62.6,0.1,0.2,0.4,1.8,0.2,98.9,0.0,53939,37487,36107,9431,34676,29,127,229,1004,89,54806,0,17832,36107,29,98,102,775,32.2,65.1,0.1,0.2,0.2,1.4
E07000227,HORSHAM,68402,68138,94.2,56.4,52.9,50.0,50.1,0.3,0.9,1.5,5.4,0.5,99.1,0.0,64464,38590,36174,34227,34289,191,585,1010,3674,352,67787,0,28290,36174,191,394,425,2664,41.4,52.9,0.3,0.6,0.6,3.9
E09000018,HOUNSLOW,103274,102940,97.0,87.4,87.3,32.4,87.2,0.0,0.1,0.4,2.6,0.0,97.1,0.0,100210,90221,90167,33478,90084,4,88,409,2730,16,100304,0,10043,90167,4,84,321,2321,9.7,87.3,0.0,0.1,0.3,2.2
E07000011,HUNTINGDONSHIRE,85269,84633,96.7,61.6,57.9,14.6,52.8,0.2,0.5,0.9,2.5,0.2,98.7,0.0,82478,52541,49340,12408,45022,139,427,773,2155,175,84122,22,33138,49340,139,288,346,1382,38.9,57.9,0.2,0.3,0.4,1.6
E07000120,HYNDBURN,41273,41046,97.9,80.0,76.7,36.8,74.1,0.0,0.1,0.2,1.6,0.0,99.3,85.0,40398,33013,31645,15202,30589,14,38,74,648,3,40979,35070,8753,31645,14,24,36,574,21.2,76.7,0.0,0.1,0.1,1.4
S12000018,INVERCLYDE,41988,41913,96.7,74.3,74.3,12.4,74.0,0.1,0.4,0.7,3.1,0.1,98.4,0.0,40593,31207,31207,5222,31084,31,148,273,1320,38,41306,0,9386,31207,31,117,125,1047,22.4,74.3,0.1,0.3,0.3,2.5
E07000202,IPSWICH,65581,65287,98.4,91.2,89.3,56.3,87.1,0.0,0.1,0.4,1.2,0.0,98.5,0.8,64509,59815,58555,36902,57148,0,50,234,778,2,64603,495,5954,58555,0,50,184,544,9.1,89.3,0.0,0.1,0.3,0.8
W06000001,ISLE OF ANGLESEY,37756,37499,91.9,22.1,22.0,22.1,22.1,0.7,1.7,2.8,7.4,0.9,96.8,24.9,34701,8331,8305,8331,8331,271,631,1072,2798,357,36529,9396,26396,8305,271,360,441,1726,69.9,22.0,0.7,1.0,1.2,4.6
E06000046,ISLE OF WIGHT,78550,78111,94.2,53.9,53.9,53.9,53.9,0.3,0.7,1.2,5.3,0.3,99.2,0.0,73967,42353,42353,42353,42353,206,524,918,4144,199,77931,0,31614,42353,206,318,394,3226,40.2,53.9,0.3,0.4,0.5,4.1
E06000053,ISLES OF SCILLY,1686,1669,96.7,1.6,1.6,1.6,1.6,0.0,0.0,0.1,2.3,0.1,99.0,0.0,1631,27,27,27,27,0,0,2,38,1,1669,0,1604,27,0,0,2,36,95.1,1.6,0.0,0.0,0.1,2.1
E09000019,ISLINGTON,119320,118938,96.6,88.3,88.3,46.2,87.6,0.0,0.0,0.0,3.1,0.0,96.6,0.0,115215,105302,105300,55068,104474,0,0,24,3723,3,115221,0,9915,105300,0,0,24,3699,8.3,88.3,0.0,0.0,0.0,3.1
E09000020,KENSINGTON AND CHELSEA,98329,98087,97.3,90.9,89.6,47.0,85.1,0.0,0.0,0.2,2.4,0.0,97.3,0.0,95692,89344,88131,46180,83651,0,0,155,2395,2,95693,0,7561,88131,0,0,155,2240,7.7,89.6,0.0,0.0,0.2,2.3
E07000146,"KING'S LYNN AND WEST NORFOLK",79003,78645,93.5,40.1,38.9,37.8,38.2,0.4,0.9,1.6,6.1,0.5,98.2,0.0,73851,31661,30757,29828,30186,300,696,1274,4794,384,77614,12,43094,30757,300,396,578,3520,54.5,38.9,0.4,0.5,0.7,4.5
E06000010,"KINGSTON UPON HULL, CITY OF",129893,127979,98.5,97.7,97.7,97.7,97.7,0.0,0.0,0.0,0.0,0.0,98.5,31.8,127960,126960,126957,126960,126960,1,1,9,19,13,127960,41273,1003,126957,1,0,8,10,0.8,97.7,0.0,0.0,0.0,0.0
E09000021,KINGSTON UPON THAMES,71121,71007,98.2,90.9,89.0,6.5,85.4,0.0,0.0,0.1,1.6,0.0,98.5,0.0,69835,64632,63270,4592,60737,1,3,72,1172,6,70087,0,6565,63270,1,2,69,1100,9.2,89.0,0.0,0.0,0.1,1.5
E08000034,KIRKLEES,199649,199126,97.5,78.7,78.7,50.0,78.6,0.0,0.2,0.4,2.2,0.0,99.0,14.7,194730,157060,157060,99916,156893,74,332,829,4396,37,197602,29297,37670,157060,74,258,497,3567,18.9,78.7,0.0,0.1,0.2,1.8
E08000011,KNOWSLEY,73852,73583,98.7,89.7,89.7,58.3,86.0,0.0,0.2,0.2,1.0,0.0,99.2,6.5,72876,66261,66261,43023,63476,23,116,163,707,15,73291,4776,6615,66261,23,93,47,544,9.0,89.7,0.0,0.1,0.1,0.7
E09000022,LAMBETH,155213,154470,97.5,85.7,83.6,52.3,79.0,0.0,0.0,0.0,2.1,0.0,97.6,0.0,151282,133070,129731,81243,122586,0,3,5,3188,13,151445,0,21551,129731,0,3,2,3183,13.9,83.6,0.0,0.0,0.0,2.1
E07000121,LANCASTER,68450,68174,97.8,74.9,70.0,53.4,67.3,0.2,0.3,0.4,1.8,0.0,99.3,2.1,66955,51250,47900,36533,46094,143,193,307,1219,24,67987,1452,19055,47900,143,50,114,912,27.8,70.0,0.2,0.1,0.2,1.3
E08000035,LEEDS,382552,381740,97.1,90.1,89.4,72.6,88.4,0.0,0.2,0.3,2.7,0.0,97.7,12.0,371595,344831,341836,277769,338266,89,674,1275,10145,123,373705,45965,29759,341836,89,585,601,8870,7.8,89.4,0.0,0.2,0.2,2.3
E06000016,LEICESTER,146759,146405,99.1,94.9,94.2,49.9,93.2,0.0,0.0,0.1,0.7,0.0,99.1,0.0,145374,139271,138312,73201,136834,13,36,165,1031,11,145467,0,7062,138312,13,23,129,866,4.8,94.2,0.0,0.0,0.1,0.6
E07000063,LEWES,48266,48190,97.6,54.4,54.4,54.3,54.4,0.1,0.2,0.4,2.2,0.1,99.7,0.0,47111,26250,26250,26217,26249,26,93,174,1079,37,48101,0,20861,26250,26,67,81,905,43.2,54.4,0.1,0.1,0.2,1.9
E09000023,LEWISHAM,140378,138367,95.6,74.3,73.6,39.4,71.7,0.0,0.0,0.2,2.9,0.0,95.8,0.0,134270,104370,103371,55342,100670,1,62,320,4097,22,134548,0,30899,103371,1,61,258,3777,22.0,73.6,0.0,0.0,0.2,2.7
E07000194,LICHFIELD,49745,49671,96.2,75.9,73.5,42.3,71.3,0.2,0.5,1.1,3.6,0.1,99.5,0.0,47861,37761,36547,21050,35463,121,271,538,1810,47,49491,12,11314,36547,121,150,267,1272,22.7,73.5,0.2,0.3,0.5,2.6
E07000138,LINCOLN,48691,48400,97.7,82.4,82.3,5.8,81.6,0.0,0.2,0.5,1.7,0.0,97.9,70.5,47573,40131,40090,2806,39742,11,92,244,827,5,47670,34349,7483,40090,11,81,152,583,15.4,82.3,0.0,0.2,0.3,1.2
N09000007,LISBURN AND CASTLEREAGH,66226,65952,95.6,87.7,87.7,84.9,87.6,0.2,0.9,1.6,4.0,0.4,99.1,0.0,63284,58049,58049,56220,58047,124,610,1036,2668,268,65623,0,5235,58049,124,486,426,1632,7.9,87.7,0.2,0.7,0.6,2.5
E08000012,LIVERPOOL,236101,234523,94.6,84.5,82.6,45.4,63.1,0.0,0.0,0.3,4.7,0.0,95.0,0.0,223466,199450,195017,107154,149003,0,49,626,11057,5,224290,0,28449,195017,0,49,577,10431,12.0,82.6,0.0,0.0,0.2,4.4
E06000032,LUTON,87438,87233,99.1,94.3,92.8,7.2,90.7,0.0,0.1,0.2,0.7,0.0,99.2,0.0,86659,82412,81105,6309,79303,6,98,183,574,3,86782,0,5554,81105,6,92,85,391,6.4,92.8,0.0,0.1,0.1,0.4
E07000110,MAIDSTONE,80835,80440,94.0,76.2,72.6,35.3,69.4,0.3,0.8,1.3,5.5,0.3,97.9,28.7,76001,61627,58688,28505,56106,277,621,1056,4439,277,79177,23218,17313,58688,277,344,435,3383,21.4,72.6,0.3,0.4,0.5,4.2
E07000074,MALDON,30848,30734,96.0,58.7,58.7,58.7,58.7,0.3,0.7,1.5,3.6,0.2,99.3,11.6,29622,18104,18104,18104,18104,82,224,456,1112,69,30644,3578,11518,18104,82,142,232,656,37.3,58.7,0.3,0.5,0.8,2.1
E07000235,MALVERN HILLS,39147,38970,92.7,39.3,32.5,30.3,30.3,0.3,1.3,2.3,6.9,0.4,98.4,5.8,36279,15382,12740,11865,11865,136,500,897,2691,157,38524,2272,23539,12740,136,364,397,1794,60.1,32.5,0.3,0.9,1.0,4.6
E08000003,MANCHESTER,252998,247378,93.4,79.4,77.2,40.3,75.2,0.0,0.1,0.7,4.4,0.0,93.7,0.0,236275,200926,195270,101929,190303,22,268,1847,11103,4,237042,53,41005,195270,22,246,1579,9256,16.2,77.2,0.0,0.1,0.6,3.7
E07000174,MANSFIELD,53709,53609,98.8,88.8,86.8,11.0,84.8,0.0,0.0,0.2,1.0,0.0,99.5,0.0,53061,47685,46631,5897,45527,8,25,85,548,4,53421,0,6430,46631,8,17,60,463,12.0,86.8,0.0,0.0,0.1,0.9
E06000035,MEDWAY,123924,123667,97.4,87.1,85.0,47.5,82.4,0.0,0.4,0.9,2.4,0.1,98.6,2.8,120709,107880,105329,58924,102085,40,508,1060,2958,78,122233,3506,15380,105329,40,468,552,1898,12.4,85.0,0.0,0.4,0.4,1.5
E07000133,MELTON,25190,25097,93.7,47.6,47.3,4.0,47.0,0.6,1.6,2.7,6.0,0.9,97.2,5.8,23598,11985,11906,1000,11839,162,411,691,1499,233,24481,1456,11692,11906,162,249,280,808,46.4,47.3,0.6,1.0,1.1,3.2
E07000187,MENDIP,56454,56235,89.5,67.5,65.3,46.5,63.6,0.4,1.5,3.7,10.2,0.4,95.5,12.4,50502,38124,36879,26276,35925,228,840,2081,5733,198,53906,7019,13623,36879,228,612,1241,3652,24.1,65.3,0.4,1.1,2.2,6.5
W06000024,MERTHYR TYDFIL,28652,28551,98.5,60.6,60.6,60.6,60.6,0.0,0.2,0.3,1.1,0.1,99.4,10.1,28233,17373,17373,17373,17373,14,46,86,318,15,28489,2887,10860,17373,14,32,40,232,37.9,60.6,0.0,0.1,0.1,0.8
E09000024,MERTON,91096,91011,99.0,89.9,89.9,44.6,86.8,0.0,0.0,0.1,0.9,0.0,99.0,0.0,90159,81940,81929,40662,79026,0,31,102,852,3,90189,0,8230,81929,0,31,71,750,9.0,89.9,0.0,0.0,0.1,0.8
N09000008,MID AND EAST ANTRIM,65860,65240,93.6,85.7,85.7,85.7,85.7,1.2,2.2,2.8,5.4,0.5,98.7,0.0,61670,56436,56436,56433,56436,822,1449,1868,3570,298,64989,0,5234,56436,822,627,419,1702,7.9,85.7,1.2,1.0,0.6,2.6
E07000042,MID DEVON,38090,37860,81.3,33.6,31.1,33.6,33.6,1.5,4.7,8.2,18.1,1.7,92.8,11.5,30972,12795,11845,12793,12795,558,1775,3139,6888,640,35334,4384,19127,11845,558,1217,1364,3749,50.2,31.1,1.5,3.2,3.6,9.8
E07000203,MID SUFFOLK,50067,49833,94.2,39.6,39.0,38.6,38.6,0.3,0.7,1.3,5.4,0.5,98.8,0.1,47142,19849,19540,19337,19340,161,327,661,2691,246,49475,31,27602,19540,161,166,334,2030,55.1,39.0,0.3,0.3,0.7,4.1
E07000228,MID SUSSEX,70294,70123,96.4,46.8,46.1,45.4,45.4,0.0,0.1,0.6,3.3,0.2,99.3,0.0,67773,32918,32395,31902,31914,23,105,389,2350,127,69810,0,35378,32395,23,82,284,1961,50.3,46.1,0.0,0.1,0.4,2.8
N09000009,MID ULSTER,62569,61880,87.6,74.5,74.5,74.5,74.5,2.4,4.1,6.0,11.3,2.5,97.9,0.0,54795,46641,46641,46641,46641,1501,2559,3727,7085,1562,61285,0,8154,46641,1501,1058,1168,3358,13.0,74.5,2.4,1.7,1.9,5.4
E06000002,MIDDLESBROUGH,69115,68769,97.8,94.0,94.0,19.5,93.7,0.0,0.2,0.6,1.6,0.1,98.1,2.0,67629,64997,64997,13452,64794,9,163,391,1140,56,67802,1376,2632,64997,9,154,228,749,3.8,94.0,0.0,0.2,0.3,1.1
S12000019,MIDLOTHIAN,43714,43314,95.8,71.9,71.9,71.9,71.9,0.5,0.9,1.4,3.3,0.4,97.9,4.5,41886,31442,31442,31440,31441,223,404,616,1428,186,42798,1981,10444,31442,223,181,212,812,23.9,71.9,0.5,0.4,0.5,1.9
E06000042,MILTON KEYNES,126331,126096,98.4,91.1,90.2,89.5,89.5,0.0,0.3,0.8,1.4,0.0,99.0,0.0,124316,115143,114012,113044,113061,55,350,964,1780,42,125046,1,10304,114012,55,295,614,816,8.2,90.2,0.0,0.2,0.5,0.6
E07000210,MOLE VALLEY,40325,40235,95.8,64.5,64.5,19.0,64.5,0.1,0.2,0.6,3.9,0.2,99.3,0.0,38646,26004,26004,7642,25992,24,68,243,1589,90,40056,0,12642,26004,24,44,175,1346,31.4,64.5,0.1,0.1,0.4,3.3
W06000021,MONMOUTHSHIRE,46383,46086,89.1,40.6,33.3,28.5,28.5,1.1,2.6,5.0,10.3,1.8,96.2,0.3,41309,18809,15449,13228,13228,525,1215,2328,4777,820,44614,118,25860,15449,525,690,1113,2449,55.8,33.3,1.1,1.5,2.4,5.3
S12000020,MORAY,50245,49894,85.4,42.6,42.6,42.6,42.6,1.4,3.8,6.4,13.9,2.3,95.4,34.4,42896,21409,21409,21409,21409,689,1891,3222,6998,1160,47914,17276,21487,21409,689,1202,1331,3776,42.8,42.6,1.4,2.4,2.6,7.5
S12000013,NA H-EILEANAN SIAR,16943,15655,76.9,5.2,5.2,5.2,5.2,2.2,3.4,5.2,15.5,3.5,88.8,0.0,13030,877,877,877,877,379,570,874,2625,595,15047,0,12153,877,379,191,304,1751,71.7,5.2,2.2,1.1,1.8,10.3
W06000012,NEATH PORT TALBOT,69160,69050,97.3,62.5,62.5,8.6,62.5,0.1,0.2,0.4,2.5,0.1,99.1,32.5,67313,43251,43250,5916,43239,56,150,274,1737,65,68553,22454,24063,43250,56,94,124,1463,34.8,62.5,0.1,0.1,0.2,2.1
E07000091,NEW FOREST,87852,87633,94.5,45.1,43.6,31.7,42.7,0.4,0.7,1.1,5.2,0.4,99.3,0.0,83027,39625,38328,27832,37471,341,603,943,4606,382,87208,41,44699,38328,341,262,340,3663,50.9,43.6,0.4,0.3,0.4,4.2
E07000175,NEWARK AND SHERWOOD,60612,60309,96.2,59.3,59.3,22.2,57.5,0.2,0.5,1.1,3.3,0.2,99.0,23.0,58337,35973,35943,13439,34832,143,320,696,1972,104,59976,13967,22394,35943,143,177,376,1276,36.9,59.3,0.2,0.3,0.6,2.1
E08000021,NEWCASTLE UPON TYNE,141555,140843,96.8,81.6,79.7,55.2,77.9,0.0,0.1,0.2,2.7,0.0,97.4,0.0,137050,115555,112828,78115,110258,47,123,216,3793,28,137857,55,24222,112828,47,76,93,3577,17.1,79.7,0.0,0.1,0.1,2.5
E07000195,NEWCASTLE-UNDER-LYME,61372,60365,95.5,68.8,67.8,20.8,67.1,0.0,0.3,0.6,2.9,0.1,97.7,2.0,58593,42221,41613,12794,41183,27,170,388,1772,56,59967,1253,16980,41613,27,143,218,1384,27.7,67.8,0.0,0.2,0.4,2.3
E09000025,NEWHAM,132037,131457,98.3,91.0,87.8,63.7,84.1,0.0,0.1,0.4,1.2,0.0,98.3,0.0,129817,120138,115988,84131,111045,32,114,567,1640,25,129833,0,13829,115988,32,82,453,1073,10.5,87.8,0.0,0.1,0.3,0.8
W06000022,NEWPORT,73441,73160,97.5,76.4,74.2,32.0,72.7,0.1,0.3,0.6,2.2,0.1,98.2,33.6,71573,56087,54475,23495,53418,65,218,440,1587,77,72090,24646,17098,54475,65,153,222,1147,23.3,74.2,0.1,0.2,0.3,1.6
N09000010,"NEWRY, MOURNE AND DOWN",78008,76730,92.0,82.6,82.6,82.6,82.6,1.1,2.1,3.0,6.3,1.4,97.9,0.0,71779,64422,64422,64422,64422,871,1652,2346,4951,1128,76361,0,7357,64422,871,781,694,2605,9.4,82.6,1.1,1.0,0.9,3.3
S12000021,NORTH AYRSHIRE,72907,72659,95.6,52.4,52.4,36.4,52.4,0.4,0.8,1.4,4.1,0.2,99.0,0.0,69677,38193,38193,26525,38191,266,570,985,2982,178,72187,0,31484,38193,266,304,415,1997,43.2,52.4,0.4,0.4,0.6,2.7
E07000043,NORTH DEVON,52650,52318,91.2,52.6,41.5,52.6,52.6,1.2,2.5,4.1,8.1,0.7,96.0,52.0,48030,27711,21856,27711,27711,621,1324,2161,4288,390,50529,27392,26174,21856,621,703,837,2127,49.7,41.5,1.2,1.3,1.6,4.0
E07000038,NORTH EAST DERBYSHIRE,49613,49473,94.0,39.9,39.0,37.3,38.3,0.2,0.7,1.1,5.7,0.1,99.0,0.0,46640,19820,19359,18529,19015,107,338,538,2833,56,49134,0,27281,19359,107,231,200,2295,55.0,39.0,0.2,0.5,0.4,4.6
E06000012,NORTH EAST LINCOLNSHIRE,75255,75109,96.8,89.1,89.1,2.6,88.6,0.1,0.8,1.3,3.0,0.2,97.6,13.0,72871,67087,67087,1942,66690,56,627,966,2238,166,73465,9816,5784,67087,56,571,339,1272,7.7,89.1,0.1,0.8,0.5,1.7
E07000099,NORTH HERTFORDSHIRE,61926,61771,96.9,77.7,76.7,24.6,75.7,0.1,0.2,0.6,2.9,0.2,98.6,0.2,60004,48142,47500,15263,46883,35,145,372,1767,98,61035,126,12504,47500,35,110,227,1395,20.2,76.7,0.1,0.2,0.4,2.3
E07000139,NORTH KESTEVEN,56045,55736,94.5,57.6,57.1,33.2,56.6,0.6,1.2,1.9,5.0,0.3,98.4,22.3,52938,32306,31991,18608,31733,339,684,1069,2798,189,55164,12478,20947,31991,339,345,385,1729,37.4,57.1,0.6,0.6,0.7,3.1
S12000050,NORTH LANARKSHIRE,166637,166408,98.3,85.4,84.8,26.8,83.4,0.1,0.3,0.5,1.6,0.1,99.2,0.0,163761,142302,141370,44639,138936,90,479,902,2647,136,165230,0,22391,141370,90,389,423,1745,13.4,84.8,0.1,0.2,0.3,1.0
E06000013,NORTH LINCOLNSHIRE,81219,80972,94.8,65.4,65.4,36.8,65.4,0.6,1.1,1.6,4.9,0.4,97.7,50.6,76961,53115,53115,29853,53095,475,918,1302,4011,285,79341,41080,23846,53115,475,443,384,2709,29.4,65.4,0.6,0.5,0.5,3.3
E07000147,NORTH NORFOLK,61361,61068,92.4,11.2,11.2,11.2,11.2,0.4,1.1,2.0,7.1,1.3,98.1,0.2,56691,6864,6864,6857,6864,254,691,1247,4377,815,60223,95,49827,6864,254,437,556,3130,81.2,11.2,0.4,0.7,0.9,5.1
E06000061,NORTH NORTHAMPTONSHIRE,165848,165382,98.3,78.9,78.9,34.8,78.9,0.1,0.3,0.5,1.4,0.1,99.0,0.0,163075,130934,130931,57764,130864,183,517,899,2307,234,164263,30,32144,130931,183,334,382,1408,19.4,78.9,0.1,0.2,0.2,0.8
E06000024,NORTH SOMERSET,104186,103905,94.6,70.6,66.1,46.5,62.9,0.1,0.6,1.0,5.1,0.3,97.3,0.0,98551,73601,68901,48479,65569,143,601,1060,5354,296,101347,0,29650,68901,143,458,459,4294,28.5,66.1,0.1,0.4,0.4,4.1
E08000022,NORTH TYNESIDE,103474,103266,99.2,87.0,85.0,45.9,82.7,0.0,0.1,0.3,0.6,0.1,99.3,0.0,102595,90006,87961,47518,85567,6,155,293,671,53,102789,0,14634,87961,6,149,138,378,14.1,85.0,0.0,0.1,0.1,0.4
E07000218,NORTH WARWICKSHIRE,31079,30956,96.8,46.0,44.3,30.4,42.9,0.3,0.7,1.0,2.8,0.1,99.1,0.0,30092,14284,13769,9436,13343,79,229,317,864,33,30811,0,16323,13769,79,150,88,547,52.5,44.3,0.3,0.5,0.3,1.8
E07000134,NORTH WEST LEICESTERSHIRE,50206,50082,97.6,76.1,74.8,19.1,73.5,0.1,0.5,0.8,2.2,0.1,99.2,0.0,48981,38193,37576,9612,36882,74,264,421,1101,61,49808,0,11405,37576,74,190,157,680,22.7,74.8,0.1,0.4,0.3,1.4
E06000057,NORTHUMBERLAND,161949,161485,93.9,35.0,33.6,32.4,32.5,0.7,1.4,2.1,5.8,0.6,98.8,2.5,152125,56648,54381,52429,52704,1176,2241,3427,9360,1020,160026,4113,97744,54381,1176,1065,1186,5933,60.4,33.6,0.7,0.7,0.7,3.7
E07000148,NORWICH,57899,57689,98.6,89.1,87.2,38.9,85.0,0.0,0.0,0.2,1.0,0.0,98.9,0.0,57095,51587,50496,22499,49220,2,5,127,594,8,57245,2,6599,50496,2,3,122,467,11.4,87.2,0.0,0.0,0.2,0.8
E06000018,NOTTINGHAM,144167,143919,98.3,93.4,92.9,48.8,91.1,0.0,0.1,0.2,1.5,0.0,98.4,0.0,141712,134709,133892,70407,131387,43,93,293,2207,8,141858,0,7820,133892,43,50,200,1914,5.4,92.9,0.0,0.0,0.1,1.3
E07000219,NUNEATON AND BEDWORTH,61955,61768,98.8,86.3,86.3,20.5,86.3,0.0,0.2,0.2,0.9,0.0,99.3,0.0,61221,53482,53482,12687,53452,25,100,126,547,4,61513,0,7739,53482,25,75,26,421,12.5,86.3,0.0,0.1,0.0,0.7
E07000135,OADBY AND WIGSTON,25652,25535,98.8,81.2,78.5,11.8,74.1,0.0,0.0,0.0,0.8,0.0,99.3,0.0,25339,20817,20149,3035,19004,0,3,11,196,0,25484,0,5190,20149,0,3,8,185,20.2,78.5,0.0,0.0,0.0,0.7
E08000004,OLDHAM,99342,99163,98.5,85.1,84.8,36.9,84.5,0.1,0.2,0.2,1.3,0.0,99.7,0.3,97870,84514,84251,36634,83962,75,158,213,1293,16,99031,324,13619,84251,75,83,55,1080,13.7,84.8,0.1,0.1,0.1,1.1
S12000023,ORKNEY ISLANDS,13131,12785,65.5,2.0,2.0,2.0,2.0,2.6,6.4,17.3,31.9,5.4,77.0,0.0,8602,264,264,264,264,343,841,2276,4183,712,10105,0,8338,264,343,498,1435,1907,63.5,2.0,2.6,3.8,10.9,14.5
E07000178,OXFORD,68991,64724,92.6,79.9,75.7,2.1,71.9,0.0,0.0,0.4,1.2,0.5,92.7,0.0,63870,55153,52253,1451,49620,2,24,281,854,354,63970,0,11617,52253,2,22,257,573,16.8,75.7,0.0,0.0,0.4,0.8
W06000009,PEMBROKESHIRE,66503,66358,91.4,20.7,20.7,20.7,20.7,1.2,2.6,4.1,8.4,1.0,96.3,2.9,60763,13740,13740,13740,13740,810,1728,2733,5595,638,64073,1947,47023,13740,810,918,1005,2862,70.7,20.7,1.2,1.4,1.5,4.3
E07000122,PENDLE,44598,44328,96.2,68.4,68.1,34.2,67.6,0.4,0.8,1.1,3.2,0.1,98.7,52.6,42883,30507,30359,15269,30167,172,371,496,1445,56,43999,23454,12524,30359,172,199,125,949,28.1,68.1,0.4,0.4,0.3,2.1
S12000048,PERTH AND KINROSS,80101,79626,85.9,39.8,39.1,10.7,38.4,1.4,3.6,6.5,13.5,1.4,95.3,0.0,68846,31908,31318,8568,30771,1092,2886,5183,10780,1148,76373,1,37528,31318,1092,1794,2297,5597,46.9,39.1,1.4,2.2,2.9,7.0
E06000031,PETERBOROUGH,94242,93990,98.6,89.7,89.4,86.6,86.8,0.1,0.2,0.4,1.1,0.1,99.3,0.0,92920,84538,84289,81644,81767,52,207,350,1070,56,93623,0,8631,84289,52,155,143,720,9.2,89.4,0.1,0.2,0.2,0.8
E06000026,PLYMOUTH,127362,126258,96.8,90.0,89.2,20.9,88.4,0.0,0.1,0.8,2.3,0.0,97.2,26.6,123346,114597,113592,26598,112567,0,159,1006,2912,7,123839,33925,9754,113592,0,159,847,1906,7.7,89.2,0.0,0.1,0.7,1.5
E06000044,PORTSMOUTH,96208,95881,97.7,95.8,94.6,47.6,93.1,0.0,0.2,0.4,1.9,0.0,97.8,0.0,94042,92193,91026,45764,89600,1,157,421,1839,2,94092,0,3016,91026,1,156,264,1418,3.1,94.6,0.0,0.2,0.3,1.5
W06000023,POWYS,70448,69221,81.5,26.0,25.9,26.0,26.0,3.0,6.4,9.8,16.8,3.9,89.9,6.2,57388,18344,18264,18341,18344,2103,4489,6870,11833,2777,63354,4397,39124,18264,2103,2386,2381,4963,55.5,25.9,3.0,3.4,3.4,7.0
E07000123,PRESTON,69593,69386,97.8,74.9,73.8,20.4,72.2,0.0,0.1,0.3,1.9,0.0,98.9,61.8,68044,52140,51329,14170,50248,29,57,176,1342,13,68848,42999,16715,51329,29,28,119,1166,24.0,73.8,0.0,0.0,0.2,1.7
E06000038,READING,76929,76231,98.0,92.1,90.1,51.3,88.2,0.0,0.0,0.2,1.1,0.0,98.1,0.0,75378,70850,69323,39468,67815,2,35,116,853,26,75453,0,6055,69323,2,33,81,737,7.9,90.1,0.0,0.0,0.1,1.0
E09000026,REDBRIDGE,111958,111699,98.4,89.3,88.6,45.4,87.0,0.0,0.1,0.2,1.4,0.0,98.6,0.0,110150,100000,99193,50834,97381,15,100,263,1549,2,110423,1,10957,99193,15,85,163,1286,9.8,88.6,0.0,0.1,0.1,1.1
E06000003,REDCAR AND CLEVELAND,68960,68852,97.6,88.5,87.8,7.3,87.1,0.1,0.4,1.0,2.2,0.1,98.8,0.7,67336,61000,60527,5049,60070,98,274,660,1516,85,68112,475,6809,60527,98,176,386,856,9.9,87.8,0.1,0.3,0.6,1.2
E07000236,REDDITCH,40186,39950,98.3,82.4,82.4,8.7,81.7,0.0,0.0,0.1,1.1,0.0,99.1,0.0,39500,33128,33126,3489,32815,3,12,45,450,19,39808,7,6374,33126,3,9,33,405,15.9,82.4,0.0,0.0,0.1,1.0
E07000211,REIGATE AND BANSTEAD,65294,65164,97.8,81.3,80.8,35.8,79.5,0.0,0.1,0.1,2.0,0.0,99.6,0.0,63844,53075,52732,23392,51929,23,50,75,1320,22,65053,0,11112,52732,23,27,25,1245,17.0,80.8,0.0,0.0,0.0,1.9
S12000038,RENFREWSHIRE,96776,96562,97.6,90.6,90.6,73.5,90.6,0.1,0.3,0.7,2.2,0.0,98.6,0.0,94414,87709,87709,71129,87697,114,275,630,2148,38,95429,0,6705,87709,114,161,355,1518,6.9,90.6,0.1,0.2,0.4,1.6
W06000016,RHONDDA CYNON TAF,119686,119205,97.7,41.0,39.2,30.7,37.9,0.0,0.1,0.3,1.9,0.0,99.0,26.6,116934,49053,46914,36747,45383,41,78,341,2271,56,118513,31881,70020,46914,41,37,263,1930,58.5,39.2,0.0,0.0,0.2,1.6
E07000124,RIBBLE VALLEY,31145,31017,93.0,62.6,62.5,61.5,62.4,0.6,1.5,2.7,6.6,0.2,98.6,79.1,28955,19483,19454,19150,19426,179,469,855,2062,63,30702,24633,9501,19454,179,290,386,1207,30.5,62.5,0.6,0.9,1.2,3.9
E09000027,RICHMOND UPON THAMES,89031,88802,98.2,89.5,88.3,35.6,87.1,0.0,0.0,0.2,1.5,0.0,98.3,0.0,87457,79674,78570,31714,77518,1,17,144,1345,7,87559,0,8887,78570,1,16,127,1201,10.0,88.3,0.0,0.0,0.1,1.3
E07000166,RICHMONDSHIRE,25332,25217,87.5,32.4,23.1,17.1,17.1,1.7,3.7,5.9,12.0,2.1,96.6,24.6,22173,8199,5853,4325,4325,432,927,1499,3044,536,24474,6226,16320,5853,432,495,572,1545,64.4,23.1,1.7,2.0,2.3,6.1
E08000005,ROCHDALE,102461,102270,97.8,74.0,68.5,15.8,63.8,0.0,0.1,0.3,2.0,0.0,99.3,0.0,100212,75779,70164,16166,65376,22,123,336,2058,10,101694,0,30048,70164,22,101,213,1722,29.3,68.5,0.0,0.1,0.2,1.7
E07000075,ROCHFORD,38740,38568,98.4,48.2,44.7,42.1,42.1,0.0,0.1,0.3,1.2,0.0,99.3,0.0,38112,18674,17331,16295,16297,1,58,97,456,14,38474,0,20781,17331,1,57,39,359,53.6,44.7,0.0,0.1,0.1,0.9
E07000125,ROSSENDALE,34947,34833,93.9,54.5,45.6,4.3,37.7,0.1,0.8,1.0,5.7,0.1,98.6,0.1,32828,19044,15922,1487,13165,44,276,356,2005,47,34462,50,16906,15922,44,232,80,1649,48.4,45.6,0.1,0.7,0.2,4.7
E07000064,ROTHER,50123,49808,95.6,49.3,49.3,49.3,49.3,0.1,0.2,0.7,3.8,0.2,99.1,0.7,47894,24693,24693,24693,24693,43,119,349,1914,108,49669,340,23201,24693,43,76,230,1565,46.3,49.3,0.1,0.2,0.5,3.1
E08000018,ROTHERHAM,126125,125870,98.3,66.7,64.7,29.3,63.5,0.0,0.2,0.5,1.5,0.1,99.2,0.2,124025,84126,81620,36898,80061,26,284,569,1845,65,125078,248,42405,81620,26,258,285,1276,33.6,64.7,0.0,0.2,0.2,1.0
E07000220,RUGBY,51573,51420,97.8,72.7,70.1,32.1,67.7,0.2,0.4,0.7,1.9,0.1,99.1,0.0,50422,37487,36153,16555,34931,122,227,354,998,41,51087,2,14269,36153,122,105,127,644,27.7,70.1,0.2,0.2,0.2,1.2
E07000212,RUNNYMEDE,39187,39004,97.0,77.9,76.3,30.0,74.4,0.0,0.0,0.7,2.5,0.0,97.9,0.0,38021,30512,29903,11739,29174,1,19,275,983,11,38379,0,8118,29903,1,18,256,708,20.7,76.3,0.0,0.0,0.7,1.8
E07000176,RUSHCLIFFE,55811,55642,97.6,78.9,76.4,44.2,73.9,0.2,0.4,0.7,2.1,0.1,99.4,5.8,54458,44041,42620,24655,41231,84,209,411,1184,80,55449,3233,11838,42620,84,125,202,773,21.2,76.4,0.2,0.2,0.4,1.4
E07000092,RUSHMOOR,43645,43555,97.7,84.5,84.5,29.2,84.3,0.0,0.8,1.6,2.1,0.1,97.9,0.0,42655,36878,36878,12749,36788,18,364,699,900,33,42742,0,5777,36878,18,346,335,201,13.2,84.5,0.0,0.8,0.8,0.5
E06000017,RUTLAND,18873,18803,91.8,24.2,24.2,24.2,24.2,0.3,0.5,0.8,7.8,0.2,99.2,0.2,17330,4573,4573,4573,4573,52,90,156,1473,32,18716,37,12757,4573,52,38,66,1317,67.6,24.2,0.3,0.2,0.3,7.0
E07000167,RYEDALE,30597,30235,87.5,15.6,15.6,15.6,15.6,2.2,4.0,5.6,11.3,1.7,95.7,31.6,26769,4781,4781,4781,4781,659,1218,1728,3466,505,29268,9658,21988,4781,659,559,510,1738,71.9,15.6,2.2,1.8,1.7,5.7
E08000006,SALFORD,133780,133327,96.0,85.1,84.7,66.4,84.3,0.0,0.9,1.9,3.7,0.0,96.1,0.0,128366,113794,113339,88896,112818,22,1195,2503,4961,12,128587,0,15027,113339,22,1173,1308,2458,11.2,84.7,0.0,0.9,1.0,1.8
E08000028,SANDWELL,143397,143039,99.2,87.4,86.7,36.3,84.5,0.0,0.0,0.1,0.6,0.0,99.2,0.0,142183,125310,124396,52120,121167,17,62,190,856,13,142262,2,17787,124396,17,45,128,666,12.4,86.7,0.0,0.0,0.1,0.5
E07000168,SCARBOROUGH,64363,64102,94.7,5.5,5.5,5.5,5.5,0.5,1.1,1.6,4.9,0.4,98.1,25.5,60947,3528,3528,3525,3528,328,710,1036,3155,232,63111,16414,57419,3528,328,382,326,2119,89.2,5.5,0.5,0.6,0.5,3.3
S12000026,SCOTTISH BORDERS,65439,64872,87.2,29.5,27.4,25.8,25.8,1.4,3.3,5.9,11.9,2.2,95.1,15.5,57087,19302,17904,16871,16871,886,2145,3846,7785,1416,62259,10143,39183,17904,886,1259,1701,3939,59.9,27.4,1.4,1.9,2.6,6.0
E07000188,SEDGEMOOR,60596,60417,94.4,67.4,64.2,62.0,62.0,0.2,0.7,1.6,5.3,0.3,97.8,0.0,57209,40836,38880,37583,37583,148,438,951,3208,209,59293,0,18329,38880,148,290,513,2257,30.2,64.2,0.2,0.5,0.8,3.7
E08000014,SEFTON,138127,137069,98.3,75.8,70.5,43.2,57.9,0.0,0.0,0.2,1.0,0.1,98.9,0.3,135723,104680,97420,59738,80026,4,53,220,1346,70,136646,353,38303,97420,4,49,167,1126,27.7,70.5,0.0,0.0,0.1,0.8
E07000169,SELBY,44108,43931,94.8,52.3,52.3,52.3,52.3,0.7,1.1,1.6,4.8,0.3,98.6,13.2,41820,23089,23089,23087,23089,290,478,714,2111,123,43491,5836,18731,23089,290,188,236,1397,42.5,52.3,0.7,0.4,0.5,3.2
E07000111,SEVENOAKS,53865,53698,94.6,66.1,66.0,43.0,65.9,0.2,0.4,0.8,5.1,0.1,99.3,0.0,50942,35601,35525,23178,35473,92,209,450,2756,79,53482,0,15417,35525,92,117,241,2306,28.6,66.0,0.2,0.2,0.4,4.3
E08000019,SHEFFIELD,264275,263407,96.8,72.4,70.6,50.5,68.9,0.0,0.1,0.7,2.9,0.0,97.4,0.1,255815,191269,186453,133540,182054,58,250,1936,7592,61,257400,198,69362,186453,58,192,1686,5656,26.2,70.6,0.0,0.1,0.6,2.1
S12000027,SHETLAND ISLANDS,13204,13063,71.2,5.0,5.0,5.0,5.0,2.8,7.1,16.5,27.7,4.8,84.1,0.0,9404,655,655,655,655,372,937,2181,3659,631,11098,0,8749,655,372,565,1244,1478,66.3,5.0,2.8,4.3,9.4,11.2
E06000051,SHROPSHIRE,155616,154991,88.9,40.6,27.1,30.0,32.8,0.8,2.3,4.3,10.7,0.4,96.1,75.6,138310,63215,42214,46744,51008,1283,3580,6751,16681,602,149623,117594,96096,42214,1283,2297,3171,9930,61.8,27.1,0.8,1.5,2.0,6.4
E06000039,SLOUGH,58328,58142,98.5,94.3,92.5,72.1,89.5,0.0,0.0,0.1,1.1,0.0,98.7,0.0,57472,54991,53930,42064,52208,4,19,51,670,4,57547,0,3542,53930,4,15,32,619,6.1,92.5,0.0,0.0,0.1,1.1
E08000029,SOLIHULL,99055,98737,98.1,91.0,90.7,53.5,90.1,0.0,0.2,0.6,1.6,0.0,98.5,0.0,97172,90169,89816,53023,89267,41,158,614,1565,29,97609,1,7356,89816,41,117,456,951,7.4,90.7,0.0,0.1,0.5,1.0
E07000246,SOMERSET WEST AND TAUNTON,79361,78995,90.8,49.6,46.5,44.9,44.9,0.7,2.1,3.6,8.8,0.8,96.7,5.4,72046,39392,36886,35672,35672,554,1669,2869,6949,613,76755,4271,35160,36886,554,1115,1200,4080,44.3,46.5,0.7,1.4,1.5,5.1
S12000028,SOUTH AYRSHIRE,59802,59706,96.5,67.1,66.5,46.8,66.0,0.2,0.6,1.1,3.3,0.3,99.1,0.0,57707,40134,39753,27990,39469,110,337,682,1999,195,59283,0,17954,39753,110,227,345,1317,30.0,66.5,0.2,0.4,0.6,2.2
E07000012,SOUTH CAMBRIDGESHIRE,73803,73413,96.7,67.6,66.4,31.6,63.4,0.1,0.4,1.0,2.8,0.1,98.4,0.2,71331,49891,49000,23299,46794,84,298,709,2082,104,72642,161,22331,49000,84,214,411,1373,30.3,66.4,0.1,0.3,0.6,1.9
E07000039,SOUTH DERBYSHIRE,50784,50488,96.3,65.8,64.7,62.7,63.7,0.2,0.6,0.9,3.1,0.2,98.8,0.0,48900,33436,32866,31851,32373,106,322,482,1588,111,50179,0,16034,32866,106,216,160,1106,31.6,64.7,0.2,0.4,0.3,2.2
E06000025,SOUTH GLOUCESTERSHIRE,129584,129296,98.3,82.2,81.9,17.6,80.8,0.1,0.2,0.5,1.4,0.1,99.3,0.0,127432,106469,106097,22848,104645,89,243,623,1864,89,128659,0,21335,106097,89,154,380,1241,16.5,81.9,0.1,0.1,0.3,1.0
E07000044,SOUTH HAMS,49534,48810,82.8,35.7,35.0,33.7,35.1,0.7,2.1,5.1,15.8,1.5,93.9,27.5,40999,17682,17360,16706,17407,368,1053,2513,7811,745,46534,13631,23639,17360,368,685,1460,5298,47.7,35.0,0.7,1.4,2.9,10.7
E07000140,SOUTH HOLLAND,45394,45201,90.9,46.3,45.7,45.2,45.2,0.4,1.4,2.5,8.7,0.8,98.8,0.1,41273,21011,20767,20529,20532,190,640,1136,3928,369,44865,47,20506,20767,190,450,496,2792,45.2,45.7,0.4,1.0,1.1,6.2
E07000141,SOUTH KESTEVEN,69848,69610,94.5,65.8,64.7,39.3,63.4,0.9,1.4,1.9,5.2,0.3,98.9,0.7,65980,45966,45197,27472,44267,632,999,1331,3630,190,69058,466,20783,45197,632,367,332,2299,29.8,64.7,0.9,0.5,0.5,3.3
E07000031,SOUTH LAKELAND,60926,60621,94.2,31.0,30.3,30.0,30.0,0.3,0.9,1.4,5.3,0.7,98.4,33.6,57414,18859,18478,18275,18275,196,519,878,3207,403,59973,20485,38936,18478,196,323,359,2329,63.9,30.3,0.3,0.5,0.6,3.8
S12000029,SOUTH LANARKSHIRE,163944,163733,96.6,76.4,76.1,27.6,75.6,0.3,0.7,1.4,3.3,0.2,98.9,0.0,158378,125224,124830,45220,123868,506,1215,2336,5355,313,162079,0,33548,124830,506,709,1121,3019,20.5,76.1,0.3,0.4,0.7,1.8
E07000149,SOUTH NORFOLK,67580,67370,93.7,42.3,41.6,37.3,41.3,0.3,1.0,1.7,6.0,0.9,98.7,0.0,63348,28600,28131,25229,27896,222,650,1139,4022,582,66733,16,35217,28131,222,428,489,2883,52.1,41.6,0.3,0.6,0.7,4.3
E07000179,SOUTH OXFORDSHIRE,68451,68241,97.5,69.9,62.7,46.4,65.3,0.1,0.3,0.4,2.1,0.1,99.5,0.0,66773,47881,42922,31739,44684,67,174,252,1468,67,68109,0,23851,42922,67,107,78,1216,34.8,62.7,0.1,0.2,0.1,1.8
E07000126,SOUTH RIBBLE,53994,53841,97.1,75.0,74.6,41.7,73.9,0.0,0.4,0.6,2.6,0.0,99.1,34.8,52441,40484,40278,22509,39923,15,198,309,1400,5,53530,18802,12163,40278,15,183,111,1091,22.5,74.6,0.0,0.3,0.2,2.0
E07000189,SOUTH SOMERSET,85172,84605,92.1,41.2,40.9,40.8,40.8,0.3,1.2,2.2,7.2,0.3,97.7,1.7,78465,35085,34832,34725,34725,232,1027,1833,6140,272,83196,1455,43633,34832,232,795,806,4307,51.2,40.9,0.3,0.9,0.9,5.1
E07000196,SOUTH STAFFORDSHIRE,50754,50600,93.0,40.5,36.4,33.4,33.6,0.2,0.8,1.5,6.7,0.0,98.8,5.0,47191,20541,18462,16936,17060,87,410,780,3409,20,50166,2558,28729,18462,87,323,370,2629,56.6,36.4,0.2,0.6,0.7,5.2
E08000023,SOUTH TYNESIDE,76072,76003,98.0,83.7,83.4,11.4,83.1,0.0,0.4,0.6,1.9,0.0,98.7,0.0,74580,63696,63476,8679,63243,24,293,471,1423,4,75114,0,11104,63476,24,269,178,952,14.6,83.4,0.0,0.4,0.2,1.3
E06000045,SOUTHAMPTON,114395,114199,97.8,94.9,94.3,73.3,93.6,0.0,0.0,0.3,2.0,0.0,98.0,0.0,111861,108607,107889,83866,107070,1,21,364,2338,11,112116,0,3972,107889,1,20,343,1974,3.5,94.3,0.0,0.0,0.3,1.7
E06000033,SOUTHEND-ON-SEA,87279,86980,98.3,87.0,83.3,67.3,80.0,0.0,0.0,0.0,1.4,0.0,98.4,0.2,85800,75921,72663,58751,69827,0,1,17,1180,5,85902,162,13137,72663,0,1,16,1163,15.1,83.3,0.0,0.0,0.0,1.3
E09000028,SOUTHWARK,151501,150332,94.3,82.0,81.8,57.4,77.8,0.0,0.0,0.2,5.0,0.0,94.3,0.0,142790,124239,123953,86970,117815,2,35,241,7542,14,142810,20,18837,123953,2,33,206,7301,12.4,81.8,0.0,0.0,0.1,4.8
E07000213,SPELTHORNE,45599,45511,97.4,87.0,86.0,47.0,84.7,0.0,0.0,0.5,2.4,0.0,98.1,0.0,44436,39665,39202,21448,38623,1,9,207,1075,2,44719,0,5234,39202,1,8,198,868,11.5,86.0,0.0,0.0,0.4,1.9
E07000240,ST ALBANS,65399,65200,97.8,89.2,87.8,51.6,86.2,0.0,0.1,0.3,1.9,0.1,98.7,0.0,63934,58325,57393,33730,56349,31,67,178,1266,34,64547,0,6541,57393,31,36,111,1088,10.0,87.8,0.0,0.1,0.2,1.7
E08000013,ST. HELENS,89065,88907,97.2,85.6,85.4,12.9,84.8,0.1,0.5,0.8,2.6,0.0,98.7,41.8,86563,76282,76064,11521,75537,49,436,698,2344,13,87891,37230,10499,76064,49,387,262,1646,11.8,85.4,0.1,0.4,0.3,1.8
E07000197,STAFFORD,66376,65781,93.8,67.7,67.6,21.8,67.5,0.3,0.8,1.6,5.3,0.2,97.9,0.6,62238,44905,44902,14470,44799,175,513,1073,3543,149,64996,385,17336,44902,175,338,560,2470,26.1,67.6,0.3,0.5,0.8,3.7
E07000198,STAFFORDSHIRE MOORLANDS,47055,46939,91.9,50.6,49.7,25.7,49.4,0.6,1.5,2.8,7.8,0.8,98.4,0.0,43256,23802,23371,12107,23226,278,717,1327,3683,375,46312,1,19885,23371,278,439,610,2356,42.3,49.7,0.6,0.9,1.3,5.0
E07000243,STEVENAGE,39707,39647,99.3,88.3,88.3,10.1,88.0,0.0,0.0,0.1,0.6,0.0,99.4,0.0,39412,35070,35070,4013,34957,0,19,32,235,0,39454,0,4342,35070,0,19,13,203,10.9,88.3,0.0,0.0,0.0,0.5
S12000030,STIRLING,46949,46517,89.1,51.8,49.5,48.4,48.4,1.4,2.8,4.5,10.0,2.1,96.3,0.0,41832,24343,23217,22717,22725,641,1313,2106,4685,990,45205,0,18615,23217,641,672,793,2579,39.6,49.5,1.4,1.4,1.7,5.5
E08000007,STOCKPORT,140997,140461,98.4,88.0,87.9,26.7,87.8,0.0,0.1,0.1,1.2,0.0,99.1,8.0,138773,124076,123999,37694,123817,18,91,177,1688,24,139685,11251,14774,123999,18,73,86,1511,10.5,87.9,0.0,0.1,0.1,1.1
E06000004,STOCKTON-ON-TEES,93483,93230,96.2,92.1,91.9,39.5,89.0,0.1,0.6,1.5,3.5,0.2,96.8,20.2,89947,86065,85883,36943,83187,54,515,1446,3283,183,90487,18902,4064,85883,54,461,931,1837,4.3,91.9,0.1,0.5,1.0,2.0
E06000021,STOKE-ON-TRENT,124285,123939,98.2,88.4,88.4,35.8,88.4,0.0,0.0,0.1,1.5,0.0,98.7,0.0,122097,109927,109927,44539,109869,0,52,159,1842,15,122727,0,12170,109927,0,52,107,1683,9.8,88.4,0.0,0.0,0.1,1.4
E07000221,STRATFORD-ON-AVON,68387,67938,95.1,58.7,54.6,35.2,51.4,0.3,0.8,1.3,4.2,0.4,98.0,1.1,65069,40147,37347,24061,35134,226,520,868,2869,259,67009,732,27722,37347,226,294,348,2001,40.5,54.6,0.3,0.4,0.5,2.9
E07000082,STROUD,58596,58412,92.8,33.6,33.6,32.7,33.6,0.2,0.6,1.5,6.9,0.1,95.9,1.1,54372,19707,19707,19148,19695,112,331,898,4040,69,56214,661,34665,19707,112,219,567,3142,59.2,33.6,0.2,0.4,1.0,5.4
E08000024,SUNDERLAND,138754,138386,97.1,78.5,76.6,27.5,75.5,0.1,0.2,0.7,2.6,0.0,98.0,0.0,134779,108857,106268,38104,104745,76,316,971,3607,63,136001,0,28511,106268,76,240,655,2636,20.5,76.6,0.1,0.2,0.5,1.9
E07000214,SURREY HEATH,39500,39423,98.4,80.7,80.3,44.5,79.8,0.0,0.0,0.1,1.4,0.0,99.7,0.0,38864,31872,31716,17573,31517,1,9,58,559,1,39370,0,7148,31716,1,8,49,501,18.1,80.3,0.0,0.0,0.1,1.3
E09000029,SUTTON,87878,87785,98.4,88.3,87.7,41.9,85.7,0.0,0.0,0.2,1.5,0.0,98.6,0.0,86485,77627,77069,36819,75349,11,19,159,1300,3,86677,0,9416,77069,11,8,140,1141,10.7,87.7,0.0,0.0,0.2,1.3
E07000113,SWALE,68760,68277,94.5,71.7,69.6,50.8,67.7,0.2,0.6,1.3,4.8,0.1,98.4,29.4,64956,49298,47838,34942,46575,121,431,896,3321,97,67693,20211,17118,47838,121,310,465,2425,24.9,69.6,0.2,0.5,0.7,3.5
W06000011,SWANSEA,118981,118761,98.1,83.0,80.9,36.1,79.4,0.1,0.2,0.5,1.7,0.1,98.9,49.0,116693,98755,96248,42937,94425,71,243,558,2068,101,117701,58319,20445,96248,71,172,315,1510,17.2,80.9,0.1,0.1,0.3,1.3
E06000030,SWINDON,103486,103419,95.8,90.3,89.0,76.7,87.7,0.0,0.4,1.0,4.1,0.2,96.3,0.0,99177,93417,92142,79419,90724,28,419,1053,4242,197,99619,0,7035,92142,28,391,634,3189,6.8,89.0,0.0,0.4,0.6,3.1
E08000008,TAMESIDE,116550,116182,97.5,68.7,67.9,33.4,66.6,0.0,0.0,0.1,2.2,0.0,99.3,0.0,113600,80077,79139,38901,77599,2,19,136,2582,4,115733,0,34461,79139,2,17,117,2446,29.6,67.9,0.0,0.0,0.1,2.1
E07000199,TAMWORTH,36167,36120,99.2,86.0,83.0,6.3,80.5,0.0,0.1,0.2,0.7,0.0,99.6,0.0,35876,31109,30026,2266,29120,0,36,81,244,3,36015,0,5850,30026,0,36,45,163,16.2,83.0,0.0,0.1,0.1,0.5
E07000215,TANDRIDGE,39199,39114,94.7,62.7,61.6,23.3,61.1,0.1,0.5,0.9,5.1,0.1,99.4,0.0,37117,24568,24157,9120,23934,39,180,362,1997,54,38954,0,12960,24157,39,141,182,1635,33.1,61.6,0.1,0.4,0.5,4.2
E07000045,TEIGNBRIDGE,67327,67114,89.8,53.9,52.0,34.1,53.8,0.4,1.6,3.2,9.8,0.6,97.1,28.5,60485,36287,34993,22961,36241,298,1049,2124,6629,412,65354,19215,25492,34993,298,751,1075,4505,37.9,52.0,0.4,1.1,1.6,6.7
E06000020,TELFORD AND WREKIN,84725,84389,97.7,83.0,81.0,15.2,79.2,0.1,0.2,0.4,1.9,0.1,98.9,36.8,82755,70346,68663,12911,67084,49,172,327,1634,65,83786,31148,14092,68663,49,123,155,1307,16.6,81.0,0.1,0.1,0.2,1.5
E07000076,TENDRING,76186,75635,97.8,14.8,14.8,14.8,14.8,0.1,0.2,0.3,1.5,0.1,98.8,8.1,74521,11302,11302,11295,11302,51,127,260,1114,57,75284,6137,63219,11302,51,76,133,854,83.0,14.8,0.1,0.1,0.2,1.1
E07000093,TEST VALLEY,61090,60921,93.8,68.9,68.5,21.9,65.6,0.2,0.7,2.1,5.9,0.5,98.3,0.0,57329,42080,41819,13373,40062,106,445,1254,3592,284,60033,0,15510,41819,106,339,809,2338,25.4,68.5,0.2,0.6,1.3,3.8
E07000083,TEWKESBURY,47821,46984,91.7,67.9,66.6,39.9,67.3,0.2,0.8,2.0,6.6,0.3,93.0,0.6,43850,32483,31829,19060,32206,80,373,978,3134,149,44487,297,12021,31829,80,293,605,2156,25.1,66.6,0.2,0.6,1.3,4.5
E07000114,THANET,74284,73894,97.3,63.9,63.9,63.8,63.8,0.0,0.6,0.9,2.1,0.0,99.1,24.5,72302,47476,47476,47381,47424,13,456,683,1592,24,73646,18230,24826,47476,13,443,227,909,33.4,63.9,0.0,0.6,0.3,1.2
E07000102,THREE RIVERS,39799,39654,97.5,87.2,85.3,63.6,82.3,0.2,0.3,0.4,2.1,0.0,99.4,0.0,38803,34716,33960,25310,32759,89,105,160,851,14,39555,0,4843,33960,89,16,55,691,12.2,85.3,0.2,0.0,0.1,1.7
E06000034,THURROCK,72772,72643,96.6,84.5,83.5,51.5,82.7,0.1,0.4,1.3,3.3,0.1,97.6,0.0,70262,61520,60777,37446,60165,79,274,966,2381,45,71013,5,9485,60777,79,195,692,1415,13.0,83.5,0.1,0.3,1.0,1.9
E07000115,TONBRIDGE AND MALLING,58126,57999,95.8,76.2,74.4,44.8,72.1,0.1,0.4,1.1,3.9,0.3,98.7,8.4,55709,44306,43261,26030,41932,70,249,661,2290,172,57346,4909,12448,43261,70,179,412,1629,21.4,74.4,0.1,0.3,0.7,2.8
E06000027,TORBAY,78449,77880,96.1,84.4,82.7,72.1,80.9,0.0,0.1,0.2,3.2,0.0,97.7,0.2,75403,66241,64899,56564,63483,2,82,184,2477,31,76616,129,10504,64899,2,80,102,2293,13.4,82.7,0.0,0.1,0.1,2.9
W06000020,TORFAEN,46405,46238,96.5,52.3,44.3,16.6,39.5,0.1,0.4,1.2,3.1,0.0,97.4,64.5,44793,24274,20578,7686,18330,45,188,577,1445,15,45215,29931,24215,20578,45,143,389,868,52.2,44.3,0.1,0.3,0.8,1.9
E07000046,TORRIDGE,34757,34480,82.4,30.7,25.3,30.7,30.7,2.2,5.7,9.5,16.8,1.3,93.3,45.8,28649,10677,8784,10676,10676,782,1976,3302,5831,436,32436,15923,19865,8784,782,1194,1326,2529,57.2,25.3,2.2,3.4,3.8,7.3
E09000030,TOWER HAMLETS,152253,151590,94.8,80.0,77.8,64.6,74.9,0.0,0.0,0.4,4.8,0.0,94.8,0.0,144309,121785,118438,98321,114064,0,44,627,7281,27,144330,0,25871,118438,0,44,583,6654,17.0,77.8,0.0,0.0,0.4,4.4
E08000009,TRAFFORD,109214,109064,98.0,74.3,71.1,9.0,68.3,0.0,0.3,0.3,1.8,0.0,99.1,0.2,107074,81162,77616,9873,74647,41,283,342,1990,30,108217,263,29458,77616,41,242,59,1648,27.0,71.1,0.0,0.2,0.1,1.5
E07000116,TUNBRIDGE WELLS,53827,53602,94.8,74.7,72.6,56.7,69.8,0.1,0.5,1.2,4.8,0.3,98.5,0.1,51041,40215,39055,30505,37549,44,294,660,2561,168,53024,78,11986,39055,44,250,366,1901,22.3,72.6,0.1,0.5,0.7,3.5
E07000077,UTTLESFORD,41580,41431,94.5,62.7,60.8,44.6,59.4,0.2,0.7,1.7,5.1,0.6,97.1,2.7,39312,26073,25278,18533,24688,103,272,723,2119,255,40355,1113,14034,25278,103,169,451,1396,33.8,60.8,0.2,0.4,1.1,3.4
W06000014,VALE OF GLAMORGAN,63976,63579,97.3,79.2,77.0,65.8,75.0,0.2,0.8,1.1,2.1,0.3,98.4,10.2,62232,50659,49238,42075,47971,114,485,693,1347,201,62931,6521,12994,49238,114,371,208,654,20.3,77.0,0.2,0.6,0.3,1.0
E07000180,VALE OF WHITE HORSE,64300,64085,97.4,73.2,68.5,30.4,69.7,0.1,0.3,0.5,2.2,0.1,98.9,0.0,62657,47078,44075,19555,44797,77,184,338,1428,49,63583,0,18582,44075,77,107,154,1090,28.9,68.5,0.1,0.2,0.2,1.7
E08000036,WAKEFIELD,161034,160684,97.1,73.6,73.3,56.4,73.0,0.1,0.3,0.5,2.7,0.1,98.7,12.4,156293,118463,118078,90851,117619,122,450,813,4391,109,158911,19996,38215,118078,122,328,363,3578,23.7,73.3,0.1,0.2,0.2,2.2
E08000030,WALSALL,118539,118271,98.6,82.8,81.4,24.9,79.0,0.0,0.0,0.3,1.2,0.0,99.1,0.0,116879,98155,96498,29537,93679,2,9,341,1392,38,117414,0,20381,96498,2,7,332,1051,17.2,81.4,0.0,0.0,0.3,0.9
E09000031,WALTHAM FOREST,112762,112272,96.4,89.2,88.4,47.4,87.7,0.0,0.2,0.9,3.1,0.0,96.5,0.0,108725,100613,99699,53462,98922,4,242,993,3547,21,108801,0,9026,99699,4,238,751,2554,8.0,88.4,0.0,0.2,0.7,2.3
E09000032,WANDSWORTH,159459,158003,97.1,90.3,85.6,59.7,78.0,0.0,0.0,0.2,2.0,0.1,97.1,0.0,154786,144030,136449,95148,124388,0,4,338,3217,177,154824,3,18337,136449,0,4,334,2879,11.5,85.6,0.0,0.0,0.2,1.8
E06000007,WARRINGTON,100175,99886,98.1,86.5,85.1,21.9,84.2,0.0,0.1,0.2,1.6,0.0,99.0,1.0,98316,86642,85292,21907,84342,28,91,153,1570,33,99210,1036,13024,85292,28,63,62,1417,13.0,85.1,0.0,0.1,0.1,1.4
E07000222,WARWICK,70946,70799,98.3,83.4,79.4,22.9,76.4,0.0,0.3,0.4,1.5,0.0,99.3,0.0,69756,59154,56318,16232,54238,34,183,297,1043,31,70451,1,13438,56318,34,149,114,746,18.9,79.4,0.0,0.2,0.2,1.1
E07000103,WATFORD,43155,43036,99.4,93.3,90.4,54.9,88.1,0.0,0.0,0.0,0.3,0.0,99.4,0.0,42887,40282,39018,23674,38012,0,4,16,149,1,42898,0,3869,39018,0,4,12,133,9.0,90.4,0.0,0.0,0.0,0.3
E07000216,WAVERLEY,58152,57798,94.8,52.9,50.7,41.2,49.0,0.2,0.4,0.7,4.5,0.2,99.1,0.0,55153,30788,29479,23987,28493,93,238,423,2645,120,57628,0,25674,29479,93,145,185,2222,44.1,50.7,0.2,0.2,0.3,3.8
E07000065,WEALDEN,75544,75347,96.1,46.9,46.8,46.7,46.7,0.1,0.4,0.8,3.6,0.3,99.4,0.0,72591,35441,35328,35293,35294,77,276,597,2756,197,75055,0,37263,35328,77,199,321,2159,49.3,46.8,0.1,0.3,0.4,2.9
E07000241,WELWYN HATFIELD,51029,50976,97.4,78.7,77.2,19.2,75.7,0.0,0.1,0.3,2.5,0.0,99.2,0.0,49679,40159,39385,9781,38620,9,39,153,1297,4,50610,0,10294,39385,9,30,114,1144,20.2,77.2,0.0,0.1,0.2,2.2
E06000037,WEST BERKSHIRE,73180,72950,97.7,80.1,77.4,53.6,75.2,0.0,0.4,0.7,2.0,0.1,98.5,0.0,71468,58621,56627,39230,55061,33,283,525,1482,69,72082,1,14841,56627,33,250,242,957,20.3,77.4,0.0,0.3,0.3,1.3
E07000047,WEST DEVON,27645,27222,80.0,38.4,37.5,38.4,38.4,1.2,4.8,10.0,18.5,1.5,94.8,65.9,22117,10612,10373,10612,10612,330,1331,2752,5105,408,26217,18230,11744,10373,330,1001,1421,2353,42.5,37.5,1.2,3.6,5.1,8.5
S12000039,WEST DUNBARTONSHIRE,47588,47373,98.1,90.0,88.9,4.9,87.7,0.0,0.1,0.3,1.4,0.1,98.8,0.0,46703,42810,42294,2327,41726,12,60,154,670,31,46997,0,4409,42294,12,48,94,516,9.3,88.9,0.0,0.1,0.2,1.1
E07000127,WEST LANCASHIRE,53217,53057,95.9,57.7,49.9,44.7,44.9,0.2,0.7,1.2,3.8,0.0,99.0,26.0,51024,30720,26567,23805,23879,125,386,623,2033,24,52673,13830,24457,26567,125,261,237,1410,46.0,49.9,0.2,0.5,0.4,2.6
E07000142,WEST LINDSEY,47318,47042,86.9,39.5,37.7,26.6,36.7,1.9,4.1,5.9,12.5,1.3,97.4,31.5,41105,18686,17823,12584,17371,880,1950,2774,5937,621,46068,14912,23282,17823,880,1070,824,3163,49.2,37.7,1.9,2.3,1.7,6.7
S12000040,WEST LOTHIAN,88004,87768,97.4,84.3,83.2,50.0,82.3,0.2,0.4,0.8,2.3,0.1,98.9,0.0,85729,74217,73234,43959,72401,143,338,745,2039,129,87053,0,12495,73234,143,195,407,1294,14.2,83.2,0.2,0.2,0.5,1.5
E06000062,WEST NORTHAMPTONSHIRE,189716,188443,97.7,84.0,82.1,72.9,80.7,0.1,0.4,0.7,1.7,0.1,98.4,0.2,185312,159333,155684,138277,153128,191,772,1265,3131,241,186658,397,29628,155684,191,581,493,1866,15.6,82.1,0.1,0.3,0.3,1.0
E07000181,WEST OXFORDSHIRE,54663,54531,99.1,83.4,79.8,51.2,76.8,0.0,0.0,0.1,0.7,0.1,99.4,0.0,54150,45571,43615,27970,41957,11,27,70,381,46,54351,11,10535,43615,11,16,43,311,19.3,79.8,0.0,0.0,0.1,0.6
E07000245,WEST SUFFOLK,86391,86219,97.0,60.1,57.8,48.2,56.3,0.1,0.3,0.5,2.8,0.2,99.3,0.2,83800,51915,49952,41628,48629,115,281,446,2419,160,85822,191,33848,49952,115,166,165,1973,39.2,57.8,0.1,0.2,0.2,2.3
E09000033,WESTMINSTER,165030,163576,89.9,72.1,71.7,68.4,70.6,0.0,0.0,0.0,9.3,0.0,89.9,0.0,148288,119063,118277,112850,116583,0,1,36,15288,11,148317,0,30011,118277,0,1,35,15252,18.2,71.7,0.0,0.0,0.0,9.2
E08000010,WIGAN,156640,156555,98.6,88.5,87.9,13.8,86.6,0.0,0.1,0.2,1.4,0.0,99.6,27.6,154385,138549,137658,21546,135585,29,101,289,2170,16,155976,43248,16727,137658,29,72,188,1881,10.7,87.9,0.0,0.0,0.1,1.2
E06000054,WILTSHIRE,237581,236890,95.6,58.2,57.7,38.3,57.0,0.2,0.5,1.1,4.2,0.2,98.9,1.1,227025,138296,136979,90944,135489,407,1285,2505,9865,560,235017,2594,90046,136979,407,878,1220,7360,37.9,57.7,0.2,0.4,0.5,3.1
E07000094,WINCHESTER,58498,58333,91.7,56.1,55.2,21.4,54.4,0.4,1.2,2.1,8.0,0.5,97.3,0.0,53650,32821,32264,12505,31819,254,720,1234,4683,305,56946,0,21386,32264,254,466,514,3449,36.6,55.2,0.4,0.8,0.9,5.9
E06000040,WINDSOR AND MAIDENHEAD,68290,68124,97.0,77.8,74.5,32.7,71.3,0.0,0.2,0.6,2.7,0.1,98.4,0.0,66264,53098,50871,22357,48701,24,133,376,1860,44,67218,3,15393,50871,24,109,243,1484,22.5,74.5,0.0,0.2,0.4,2.2
E08000015,WIRRAL,159242,159052,98.3,79.8,79.8,71.2,79.6,0.0,0.1,0.1,1.6,0.0,99.6,0.0,156494,127086,127086,113427,126798,56,106,165,2558,4,158675,1,29408,127086,56,50,59,2393,18.5,79.8,0.0,0.0,0.0,1.5
E07000217,WOKING,45994,45671,97.8,84.9,81.8,5.1,78.8,0.0,0.3,0.3,1.5,0.0,98.6,0.0,44980,39060,37613,2331,36232,1,143,153,691,16,45369,0,7367,37613,1,142,10,538,16.0,81.8,0.0,0.3,0.0,1.2
E06000041,WOKINGHAM,77085,76421,96.8,78.7,76.1,22.2,73.7,0.0,0.1,0.2,2.3,0.0,97.8,8.0,74644,60692,58624,17087,56793,8,79,178,1777,29,75396,6163,16020,58624,8,71,99,1599,20.8,76.1,0.0,0.1,0.1,2.1
E08000031,WOLVERHAMPTON,119447,119029,98.6,93.5,92.6,37.8,90.8,0.0,0.0,0.0,1.1,0.0,98.8,5.1,117731,111716,110567,45117,108428,0,0,15,1298,44,117974,6064,7164,110567,0,0,15,1283,6.0,92.6,0.0,0.0,0.0,1.1
E07000237,WORCESTER,49577,49383,98.8,56.2,51.5,47.0,47.0,0.0,0.0,0.0,0.8,0.0,99.2,0.0,48984,27854,25524,23292,23292,0,0,3,399,10,49203,1,23460,25524,0,0,3,396,47.3,51.5,0.0,0.0,0.0,0.8
E07000229,WORTHING,52079,52009,99.5,96.1,95.8,84.5,95.7,0.0,0.0,0.0,0.4,0.0,99.8,0.0,51797,50057,49914,44000,49816,0,0,9,212,4,51964,0,1883,49914,0,0,9,203,3.6,95.8,0.0,0.0,0.0,0.4
W06000006,WREXHAM,66672,65735,95.2,48.6,48.1,47.6,47.6,0.2,0.7,1.4,3.4,0.8,97.2,43.3,63473,32422,32097,31766,31767,132,481,928,2262,506,64830,28852,31376,32097,132,349,447,1334,47.1,48.1,0.2,0.5,0.7,2.0
E07000238,WYCHAVON,64057,63530,95.1,35.8,31.0,29.4,30.7,0.1,0.5,0.9,4.0,0.2,98.7,0.1,60942,22960,19882,18815,19685,67,339,559,2588,130,63212,45,41060,19882,67,272,220,2029,64.1,31.0,0.1,0.4,0.3,3.2
E07000128,WYRE,58069,57900,97.0,60.3,60.3,60.2,60.3,0.1,0.2,0.5,2.7,0.1,98.9,10.6,56317,35014,35013,34984,35010,42,141,263,1583,40,57419,6144,21304,35013,42,99,122,1320,36.7,60.3,0.1,0.2,0.2,2.3
E07000239,WYRE FOREST,48894,48679,97.3,55.7,55.7,10.3,55.4,0.1,0.3,0.5,2.3,0.1,99.3,3.4,47557,27255,27255,5020,27064,49,136,250,1122,69,48549,1670,20302,27255,49,87,114,872,41.5,55.7,0.1,0.2,0.2,1.8
E06000014,YORK,96526,96317,94.7,75.8,72.6,52.3,70.0,0.0,0.2,0.7,5.0,0.0,96.6,3.8,91448,73123,70059,50466,67521,42,189,694,4869,23,93230,3707,21389,70059,42,147,505,4175,22.2,72.6,0.0,0.2,0.5,4.3
