laua,laua_name,All Premises,All Matched Premises,SFBB availability (% premises),UFBB (100Mbit/s) availability (% premises),UFBB availability (% premises),Full Fibre availability (% premises),Gigabit availability (% premises),% of premises unable to receive 2Mbit/s,% of premises unable to receive 5Mbit/s,% of premises unable to receive 10Mbit/s,% of premises unable to receive 30Mbit/s,% of premises below the USO,% of premises with NGA,% of premises able to receive decent broadband from FWA,Number of premises with SFBB availability,Number of premises with UFBB (100Mbit/s) availability,Number of premises with UFBB availability,Number of premises with Full Fibre availability,Number of premises with Gigabit availability,Number of premises unable to receive 2Mbit/s,Number of premises unable to receive 5Mbit/s,Number of premises unable to receive 10Mbit/s,Number of premises unable to receive 30Mbit/s,Number of premises below the USO,Number of premises with NGA,Number of premises able to receive decent broadband from FWA,Number of premises with 30<300Mbit/s download speed,Number of premises with >=300Mbit/s download speed,Number of premises with 0<2Mbit/s download speed,Number of premises with 2<5Mbit/s download speed,Number of premises with 5<10Mbit/s download speed,Number of premises with 10<30Mbit/s download speed,% of premises with 30<300Mbit/s download speed,% of premises with >=300Mbit/s download speed,% of premises with 0<2Mbit/s download speed,% of premises with 2<5Mbit/s download speed,% of premises with 5<10Mbit/s download speed,% of premises with 10<30Mbit/s download speed
S12000033,ABERDEEN CITY,129315,129197,97.2,84.8,83.9,83,83,0,0.2,0.3,2.8,0,98,0,125636,109650,108514,107315,107315,58,209,431,3561,40,126770,0,17122,108514,58,151,222,3130,13.2,83.9,0,0.1,0.2,2.4
S12000034,ABERDEENSHIRE,128408,128070,85.9,25.5,25.5,25.4,25.4,1.7,4.2,7.6,13.8,2.4,95.4,0,110296,32794,32703,32622,32622,2214,5407,9703,17774,3047,122495,0,77593,32703,2214,3193,4296,8071,60.4,25.5,1.7,2.5,3.3,6.3
E07000223,ADUR,29985,29953,99.1,92.8,92.8,65.4,92.8,0,0,0.1,0.8,0,99.6,0,29727,27826,27826,19606,27826,0,9,40,226,5,29864,0,1901,27826,0,9,31,186,6.3,92.8,0,0,0.1,0.6
E07000026,ALLERDALE,52482,52364,93.1,6,6,6,6,1.2,2,2.8,6.6,0.6,98.7,3.4,48885,3127,3127,3127,3127,617,1057,1479,3479,294,51819,1785,45758,3127,617,440,422,2000,87.2,6,1.2,0.8,0.8,3.8
E07000032,AMBER VALLEY,62512,62430,97.2,62.4,60.6,59,59.1,0.1,0.3,0.4,2.7,0.1,99.5,0,60770,39001,37875,36868,36952,42,157,245,1660,54,62205,1,22895,37875,42,115,88,1415,36.6,60.6,0.1,0.2,0.1,2.3
S12000041,ANGUS,61881,61732,88.1,32.9,32.8,20.9,32.7,1.1,3,5.8,11.6,1.5,95.7,0,54537,20328,20269,12918,20217,704,1829,3593,7195,915,59242,0,34268,20269,704,1125,1764,3602,55.4,32.8,1.1,1.8,2.9,5.8
N09000001,ANTRIM AND NEWTOWNABBEY,65674,65229,95.5,91.1,91,90.3,91,1,1.7,2,3.8,0.5,99.1,0,62720,59808,59790,59314,59782,651,1091,1292,2509,335,65109,1,2930,59790,651,440,201,1217,4.5,91,1,0.7,0.3,1.9
N09000011,ARDS AND NORTH DOWN,78628,78576,97.6,91.7,91.7,91.1,91.7,0.3,0.5,0.9,2.3,0.1,99.9,0,76754,72082,72082,71603,72082,220,432,733,1822,85,78542,0,4672,72082,220,212,301,1089,5.9,91.7,0.3,0.3,0.4,1.4
S12000035,ARGYLL AND BUTE,57178,56495,83.1,6.4,6.4,6.4,6.4,2.8,4.8,8.4,15.7,4.2,90.8,0,47497,3683,3683,3682,3683,1584,2742,4811,8998,2405,51940,0,43814,3683,1584,1158,2069,4187,76.6,6.4,2.8,2,3.6,7.3
N09000002,"ARMAGH CITY, BANBRIDGE AND CRAIGAVON",94573,94416,95.9,87,87,87,87,0.5,1.1,1.7,4,0.6,99.3,0.2,90677,82281,82281,82281,82281,505,1086,1596,3739,521,93886,162,8396,82281,505,581,510,2143,8.9,87,0.5,0.6,0.5,2.3
E07000224,ARUN,80682,80624,97.5,39.7,36.4,34.2,34.2,0,0.1,0.2,2.4,0.1,99.9,0,78699,32036,29361,27574,27629,34,66,146,1925,71,80586,0,49338,29361,34,32,80,1779,61.2,36.4,0,0,0.1,2.2
E07000170,ASHFIELD,60013,59979,98.5,90.4,90.2,35.8,90.1,0,0.3,0.4,1.4,0,99.2,0,59119,54275,54161,21461,54087,17,204,256,860,3,59524,1,4958,54161,17,187,52,604,8.3,90.2,0,0.3,0.1,1
E07000105,ASHFORD,60702,60641,93.5,68.8,67.4,51.6,66.5,0.2,1.1,2.1,6.4,0.4,98.8,35,56743,41793,40883,31307,40349,138,646,1295,3898,216,59979,21230,15860,40883,138,508,649,2603,26.1,67.4,0.2,0.8,1.1,4.3
E07000200,BABERGH,44976,44885,96.7,37.4,37.3,37.2,37.3,0.2,0.5,0.7,3.1,0.2,99.3,4.3,43485,16841,16783,16730,16766,100,211,314,1400,86,44683,1931,26702,16783,100,111,103,1086,59.4,37.3,0.2,0.2,0.2,2.4
E09000002,BARKING AND DAGENHAM,81813,81621,98.5,92,92,72.1,92,0,0.4,0.7,1.2,0,98.5,0,80610,75303,75261,58999,75251,38,366,557,1011,15,80622,0,5349,75261,38,328,191,454,6.5,92,0,0.4,0.2,0.6
E09000003,BARNET,163798,163684,98.1,70.9,68.7,39.1,66.8,0,0,0.1,1.8,0,98.8,0,160739,116120,112520,64122,109366,1,9,242,2945,0,161777,0,48219,112520,1,8,233,2703,29.4,68.7,0,0,0.1,1.7
E08000016,BARNSLEY,119442,119385,98.7,71.8,69.1,27.7,66.9,0.1,0.2,0.3,1.3,0,99.3,35.8,117849,85814,82500,33072,79939,70,263,393,1536,2,118602,42770,35349,82500,70,193,130,1143,29.6,69.1,0.1,0.2,0.1,1
E07000027,BARROW-IN-FURNESS,35942,35925,99.1,56.8,56.8,56.8,56.8,0.1,0.2,0.3,0.9,0.1,99.9,0.3,35609,20403,20403,20403,20403,53,76,114,316,19,35914,99,15206,20403,53,23,38,202,42.3,56.8,0.1,0.1,0.1,0.6
E07000066,BASILDON,84464,84375,98.7,87.8,87.1,53.4,86.6,0,0.1,0.4,1.1,0,99.4,0,83406,74177,73605,45124,73107,27,115,308,969,4,83958,0,9801,73605,27,88,193,661,11.6,87.1,0,0.1,0.2,0.8
E07000084,BASINGSTOKE AND DEANE,83710,83598,96.6,68,66.8,49.3,66.2,0.2,0.5,0.9,3.3,0.2,98.8,0,80868,56946,55924,41285,55376,136,410,786,2730,179,82677,0,24944,55924,136,274,376,1944,29.8,66.8,0.2,0.3,0.4,2.3
E07000171,BASSETLAW,59180,58976,96.6,47.7,46,27.1,44.7,0.4,0.7,1.1,3,0.2,99.1,41.3,57176,28248,27218,16066,26468,229,425,646,1800,106,58624,24449,29958,27218,229,196,221,1154,50.6,46,0.4,0.3,0.4,1.9
E06000022,BATH AND NORTH EAST SOMERSET,89775,89584,95.5,73.7,69,50.2,65.1,0.1,0.2,0.5,4.3,0.1,97.2,0,85733,66207,61967,45033,58421,69,198,439,3851,91,87254,0,23766,61967,69,129,241,3412,26.5,69,0.1,0.1,0.3,3.8
E06000055,BEDFORD,83748,83675,97.7,80.6,78.9,44,77.3,0.2,0.3,0.6,2.2,0.1,99.1,0,81832,67483,66054,36830,64702,129,277,516,1843,48,82991,1,15778,66054,129,148,239,1327,18.8,78.9,0.2,0.2,0.3,1.6
N09000003,BELFAST,173887,173009,98.6,95.3,95.3,89.5,95.3,0,0.1,0.3,0.9,0,98.7,0,171489,165688,165686,155637,165688,40,109,506,1520,83,171649,0,5803,165686,40,69,397,1014,3.3,95.3,0,0,0.2,0.6
E09000004,BEXLEY,104988,104920,98.6,89.5,89.2,68.5,88.9,0,0.1,0.5,1.4,0,98.7,0,103475,94015,93680,71882,93340,24,84,511,1445,7,103668,0,9795,93680,24,60,427,934,9.3,89.2,0,0.1,0.4,0.9
E08000025,BIRMINGHAM,478734,476604,96.6,92.3,91.7,48.9,91,0,0.3,0.7,3,0,96.7,0,462456,441888,438931,234024,435683,84,1421,3363,14148,87,462712,0,23525,438931,84,1337,1942,10785,4.9,91.7,0,0.3,0.4,2.3
E07000129,BLABY,46023,45998,98.7,76.1,74.1,39.8,72.8,0.1,0.1,0.3,1.3,0,99.4,0,45415,35007,34098,18306,33520,31,69,120,583,3,45769,0,11317,34098,31,38,51,463,24.6,74.1,0.1,0.1,0.1,1
E06000008,BLACKBURN WITH DARWEN,68599,68498,97.9,70.9,70.7,18.4,70.5,0,0.2,0.3,1.9,0,99.1,58.7,67163,48627,48483,12590,48380,27,149,234,1335,20,67992,40279,18680,48483,27,122,85,1101,27.2,70.7,0,0.2,0.1,1.6
E06000009,BLACKPOOL,78225,77840,98.3,71.9,71.8,5.2,71.9,0,0,0,1.2,0,98.4,0,76867,56236,56186,4078,56236,22,33,34,973,0,76970,0,20681,56186,22,11,1,939,26.4,71.8,0,0,0,1.2
W06000019,BLAENAU GWENT,35485,35449,97.3,33.7,32.3,31.1,31.1,0.1,0.3,0.6,2.6,0.1,99.5,0,34529,11974,11451,11051,11051,29,96,207,920,26,35308,17,23078,11451,29,67,111,713,65,32.3,0.1,0.2,0.3,2
E07000033,BOLSOVER,40006,39958,97.3,57,53.7,32,52.1,0,0.1,0.4,2.6,0.1,99.3,0,38912,22809,21492,12792,20849,20,45,162,1046,21,39738,0,17420,21492,20,25,117,884,43.5,53.7,0,0.1,0.3,2.2
E08000001,BOLTON,134813,134564,98.6,91,89.8,48.4,88.3,0,0.1,0.2,1.2,0,99.3,1,132965,122728,121071,65314,119048,40,127,286,1599,23,133845,1298,11894,121071,40,87,159,1313,8.8,89.8,0,0.1,0.1,1
E07000136,BOSTON,33955,33683,93.8,59.6,59.6,59.6,59.6,0.5,1.2,1.8,5.4,0.5,98.2,11.8,31849,20246,20246,20246,20246,186,422,627,1834,183,33330,4004,11603,20246,186,236,205,1207,34.2,59.6,0.5,0.7,0.6,3.6
E06000058,"BOURNEMOUTH, CHRISTCHURCH AND POOLE",199779,199449,98.8,86.6,84.9,53.4,84,0.2,0.2,0.2,1.1,0,99.5,0,197301,172991,169524,106733,167726,335,361,457,2148,16,198705,0,27777,169524,335,26,96,1691,13.9,84.9,0.2,0,0,0.8
E06000036,BRACKNELL FOREST,55885,55825,97.6,90.5,89.6,79.4,88.5,0,0.1,0.3,2.3,0,98.1,0,54533,50572,50074,44387,49479,13,53,148,1292,14,54848,0,4459,50074,13,40,95,1144,8,89.6,0,0.1,0.2,2
E08000032,BRADFORD,224784,224514,97.6,89.1,87.8,46.8,86.9,0.1,0.2,0.3,2.3,0,98.6,68.6,219415,200225,197351,105105,195290,143,390,720,5099,4,221639,154225,22064,197351,143,247,330,4379,9.8,87.8,0.1,0.1,0.1,1.9
E07000067,BRAINTREE,73215,73104,97.9,59.6,59.6,59.5,59.6,0.2,0.4,0.7,2,0.1,99.1,12.3,71665,43609,43609,43575,43609,134,272,504,1439,81,72562,8999,28056,43609,134,138,232,935,38.3,59.6,0.2,0.2,0.3,1.3
E07000143,BRECKLAND,68004,67889,93.4,46.4,45.2,44.3,44.3,0.6,1.3,2.1,6.5,1.1,98.6,0.1,63496,31578,30743,30148,30148,441,900,1448,4393,727,67018,37,32753,30743,441,459,548,2945,48.2,45.2,0.6,0.7,0.8,4.3
E09000005,BRENT,142136,140914,96.8,82.3,80.5,58.8,79.3,0,0.1,0.3,2.3,0,96.9,0,137637,117008,114453,83527,112699,1,107,459,3277,1,137684,0,23184,114453,1,106,352,2818,16.3,80.5,0,0.1,0.2,2
E07000068,BRENTWOOD,36449,36398,96.2,57.3,57.3,57.3,57.3,0.1,0.4,0.5,3.7,0.1,98,0.3,35053,20896,20896,20889,20896,27,138,165,1345,25,35712,98,14157,20896,27,111,27,1180,38.8,57.3,0.1,0.3,0.1,3.2
W06000013,BRIDGEND,68269,68212,98,63.1,59.1,55.8,55.9,0,0.2,0.5,1.9,0,99.4,35.9,66888,43044,40378,38074,38132,31,108,316,1324,8,67878,24539,26510,40378,31,77,208,1008,38.8,59.1,0,0.1,0.3,1.5
E06000043,BRIGHTON AND HOVE,143388,142143,97.2,86.8,84.2,37.8,79.4,0,0.2,0.9,1.9,0,97.3,0,139371,124506,120692,54155,113921,21,357,1230,2772,7,139588,0,18679,120692,21,336,873,1542,13,84.2,0,0.2,0.6,1.1
E06000023,"BRISTOL, CITY OF",214842,214340,96.7,92.5,92.4,65.9,92.4,0,0.1,0.5,3.1,0,96.8,0,207756,198775,198496,141487,198420,15,181,1060,6584,44,207976,0,9260,198496,15,166,879,5524,4.3,92.4,0,0.1,0.4,2.6
E07000144,BROADLAND,62969,62858,96.2,55.2,54,35.8,53.4,0.2,0.4,1,3.6,0.7,99.2,0.1,60603,34743,34016,22524,33647,117,252,652,2255,428,62455,35,26587,34016,117,135,400,1603,42.2,54,0.2,0.2,0.6,2.5
E09000006,BROMLEY,147408,147362,98.6,91.2,91,42.7,90.3,0,0.1,0.2,1.3,0,99.1,0,145407,134484,134107,62938,133150,28,117,289,1955,10,146029,0,11300,134107,28,89,172,1666,7.7,91,0,0.1,0.1,1.1
E07000234,BROMSGROVE,45435,45152,97.6,78.6,78.6,58.7,78.6,0,0.2,0.3,1.7,0.1,99,0.1,44367,35713,35713,26682,35713,19,81,146,785,33,45002,41,8654,35713,19,62,65,639,19,78.6,0,0.1,0.1,1.4
E07000095,BROXBOURNE,43485,43420,98.7,88.7,85.9,7.7,82.6,0.1,0.1,0.2,1.1,0,99.3,0,42938,38580,37361,3344,35925,34,38,85,482,2,43168,0,5577,37361,34,4,47,397,12.8,85.9,0.1,0,0.1,0.9
E07000172,BROXTOWE,52819,52786,99.4,95.4,95,75.4,94.8,0,0.1,0.1,0.5,0,99.7,0,52503,50411,50189,39802,50053,20,43,72,283,1,52672,0,2314,50189,20,23,29,211,4.4,95,0,0,0.1,0.4
E06000060,BUCKINGHAMSHIRE,245485,245076,96.8,74.3,71.5,51.5,69.3,0.1,0.4,0.9,3.1,0.1,98.7,0.1,237526,182499,175472,126394,170161,262,1028,2163,7550,359,242271,312,62054,175472,262,766,1135,5387,25.3,71.5,0.1,0.3,0.5,2.2
E07000117,BURNLEY,46091,46057,98.4,84.8,84.8,48.4,84.8,0.1,0.1,0.2,1.5,0,99.6,46.3,45368,39104,39102,22313,39104,29,47,80,689,13,45885,21331,6266,39102,29,18,33,609,13.6,84.8,0.1,0,0.1,1.3
E08000002,BURY,90260,90227,99,84.7,81.5,73.7,78.4,0,0.1,0.1,1,0,99.9,0,89358,76433,73589,66482,70784,12,78,126,869,2,90142,0,15769,73589,12,66,48,743,17.5,81.5,0,0.1,0.1,0.8
W06000018,CAERPHILLY,83955,83844,98.8,55.4,53.9,52.8,52.8,0,0.1,0.2,1,0,99.8,46.5,82982,46525,45218,44318,44343,22,72,131,862,12,83763,39008,37764,45218,22,50,59,731,45,53.9,0,0.1,0.1,0.9
E08000033,CALDERDALE,104123,104040,95.6,53.6,53.6,17.9,53.5,0.1,0.3,0.6,4.3,0,98.7,64.7,99574,55859,55767,18615,55697,130,340,619,4466,43,102722,67370,43807,55767,130,210,279,3847,42.1,53.6,0.1,0.2,0.3,3.7
E07000008,CAMBRIDGE,61226,61101,98.8,94.1,93.1,75,92.1,0,0,0.1,1,0,98.8,0,60480,57588,56994,45895,56418,2,15,67,621,0,60497,0,3486,56994,2,13,52,554,5.7,93.1,0,0,0.1,0.9
E09000007,CAMDEN,122588,122122,97.6,93.6,93.5,73.8,93.6,0,0,0,2,0,97.7,0,119622,114705,114642,90448,114705,0,0,16,2500,0,119710,3,4980,114642,0,0,16,2484,4.1,93.5,0,0,0,2
E07000192,CANNOCK CHASE,48859,48775,99.2,89.4,89.4,70,88.8,0,0.1,0.1,0.7,0.1,99.6,0,48445,43682,43662,34217,43375,19,40,53,330,27,48678,0,4783,43662,19,21,13,277,9.8,89.4,0,0,0,0.6
E07000106,CANTERBURY,74815,72737,93.2,49.8,49.8,49.8,49.8,0.2,0.5,0.9,4,0.1,96.9,14.8,69731,37262,37261,37262,37262,126,364,664,3006,110,72500,11042,32470,37261,126,238,300,2342,43.4,49.8,0.2,0.3,0.4,3.1
W06000015,CARDIFF,169359,168864,98.2,90.2,89,65.5,87.8,0,0.3,0.5,1.5,0,98.6,60.9,166296,152846,150784,110897,148713,43,429,929,2568,27,166966,103140,15512,150784,43,386,500,1639,9.2,89,0,0.2,0.3,1
E07000028,CARLISLE,58539,58449,94.9,58.2,52.1,17.5,48.1,0.7,1.5,2.4,5,0.7,98.2,1.6,55542,34081,30479,10224,28173,399,862,1389,2907,425,57512,908,25063,30479,399,463,527,1518,42.8,52.1,0.7,0.8,0.9,2.6
W06000010,CARMARTHENSHIRE,94336,93782,90.6,51,51,51,51,1.3,2.8,4.4,8.8,1.4,95.3,1.6,85514,48086,48086,48142,48144,1205,2629,4194,8268,1274,89872,1545,37428,48086,1205,1424,1565,4074,39.7,51,1.3,1.5,1.7,4.3
E07000069,CASTLE POINT,41594,41395,98.6,52.9,52.9,15.2,52.9,0,0.1,0.2,0.9,0,99.2,0,41032,21987,21987,6330,21987,10,48,69,363,8,41263,0,19045,21987,10,38,21,294,45.8,52.9,0,0.1,0.1,0.7
N09000004,CAUSEWAY COAST AND GLENS,71080,70375,94.6,85.6,85.6,85.5,85.6,0.9,1.5,2,4.4,0.7,98.7,0,67240,60810,60810,60790,60810,627,1063,1450,3135,528,70133,0,6430,60810,627,436,387,1685,9,85.6,0.9,0.6,0.5,2.4
E06000056,CENTRAL BEDFORDSHIRE,137147,136571,97.2,78.6,77,41.3,75.7,0.1,0.3,0.7,2.3,0.1,98.9,0.1,133360,107859,105598,56676,103792,136,467,893,3211,196,135614,123,27762,105598,136,331,426,2318,20.2,77,0.1,0.2,0.3,1.7
W06000008,CEREDIGION,39209,38017,85.7,34,34,34,34,1.7,3.9,6.2,11.3,2.1,91.4,6.2,33604,13347,13347,13347,13347,656,1544,2438,4413,814,35838,2432,20257,13347,656,888,894,1975,51.7,34,1.7,2.3,2.3,5
E07000130,CHARNWOOD,80818,80762,98.8,78.5,75.6,27.3,73.3,0.1,0.2,0.4,1.1,0,99.7,0,79880,63465,61068,22052,59235,92,193,285,882,32,80555,0,18812,61068,92,101,92,597,23.3,75.6,0.1,0.1,0.1,0.7
E07000070,CHELMSFORD,83924,83844,96.9,72,69.8,54.4,67.6,0,0.2,0.6,3,0,98.6,1,81319,60392,58574,45621,56704,33,153,535,2525,32,82759,842,22745,58574,33,120,382,1990,27.1,69.8,0,0.1,0.5,2.4
E07000078,CHELTENHAM,60303,60261,99.3,87.3,83.9,48.5,80.7,0,0.1,0.2,0.6,0,99.5,0,59894,52649,50581,29277,48692,11,51,98,367,7,59977,0,9313,50581,11,40,47,269,15.4,83.9,0,0.1,0.1,0.4
E07000177,CHERWELL,73974,73828,97.6,74.1,70.5,54.2,67.7,0.5,0.6,0.9,2.2,0.1,98.8,0.6,72231,54839,52123,40101,50113,351,454,651,1597,51,73100,477,20108,52123,351,103,197,946,27.2,70.5,0.5,0.1,0.3,1.3
E06000049,CHESHIRE EAST,196162,195951,95.6,71.6,68.7,48.9,66.7,0.2,0.6,1.2,4.3,0.2,98.8,1.4,187574,140465,134753,96002,130817,440,1205,2345,8377,399,193719,2835,52821,134753,440,765,1140,6032,26.9,68.7,0.2,0.4,0.6,3.1
E06000050,CHESHIRE WEST AND CHESTER,173037,172732,96.4,74.6,70.5,65.1,68.3,0.2,0.5,0.9,3.4,0.1,99.1,0.4,166882,129091,122014,112576,118151,261,858,1567,5850,187,171428,770,44868,122014,261,597,709,4283,25.9,70.5,0.2,0.3,0.4,2.5
E07000034,CHESTERFIELD,54202,54153,97.9,63.2,63.2,35.3,63.2,0,0,0.2,2,0,99.3,0,53074,34241,34241,19125,34241,0,9,108,1079,1,53819,0,18833,34241,0,9,99,971,34.7,63.2,0,0,0.2,1.8
E07000225,CHICHESTER,63635,63435,93.4,40.7,39.4,38.2,38.3,0.3,0.7,1.5,6.3,0.4,99.2,0,59418,25910,25071,24319,24353,170,448,980,4017,251,63097,0,34347,25071,170,278,532,3037,54,39.4,0.3,0.4,0.8,4.8
E07000118,CHORLEY,55648,55612,97.4,81,79.3,66.4,77.7,0,0.2,0.5,2.6,0,99.5,20.8,54191,45066,44121,36925,43259,13,102,266,1421,12,55359,11566,10070,44121,13,89,164,1155,18.1,79.3,0,0.2,0.3,2.1
S12000036,CITY OF EDINBURGH,282350,282070,97.8,91.5,90.5,71.4,89.6,0,0.2,0.5,2.1,0,98.1,0,276088,258292,255653,201739,252988,139,538,1402,5982,24,276868,4,20435,255653,139,399,864,4580,7.2,90.5,0,0.1,0.3,1.6
E09000001,CITY OF LONDON,10905,10806,59.1,51.5,51.5,50.1,51.5,0,0,0.2,40,0,59.2,0,6447,5619,5619,5459,5619,0,0,17,4359,0,6451,0,828,5619,0,0,17,4342,7.6,51.5,0,0,0.2,39.8
S12000005,CLACKMANNANSHIRE,26631,26620,98.6,69.2,63.8,61.4,61.4,0.1,0.2,0.3,1.4,0.1,99.8,0,26253,18426,17003,16357,16357,26,53,88,367,18,26586,0,9250,17003,26,27,35,279,34.7,63.8,0.1,0.1,0.1,1
E07000071,COLCHESTER,89468,88641,97,70.6,70.5,27.7,70.6,0.1,0.5,0.8,2,0.3,97.8,13.2,86812,63145,63075,24743,63131,90,411,677,1829,232,87532,11837,23737,63075,90,321,266,1152,26.5,70.5,0.1,0.4,0.3,1.3
W06000003,CONWY,60046,59954,96,75.1,75.1,75.1,75.1,0.6,1.2,2.1,3.9,0.8,98.2,57.6,57632,45123,45123,45124,45124,368,744,1273,2322,462,58945,34612,12509,45123,368,376,529,1049,20.8,75.1,0.6,0.6,0.9,1.7
E07000029,COPELAND,36078,36030,95.5,2.9,2.9,2.9,2.9,0.3,0.5,1.1,4.4,0.8,99.2,0,34442,1060,1060,1060,1060,101,191,407,1588,276,35781,0,33382,1060,101,90,216,1181,92.5,2.9,0.3,0.2,0.6,3.3
E06000052,CORNWALL,306443,305299,89.6,46.2,45,42.4,44.2,0.3,1,2.1,10,0.4,94.2,12.7,274715,141666,137940,130019,135542,988,2923,6473,30584,1273,288721,39040,136775,137940,988,1935,3550,24111,44.6,45,0.3,0.6,1.2,7.9
E07000079,COTSWOLD,48359,48282,96,51.9,51.6,51.4,51.5,0.1,0.3,0.7,3.8,0.2,97.4,0.3,46432,25122,24944,24875,24881,57,167,346,1850,101,47088,133,21488,24944,57,110,179,1504,44.4,51.6,0.1,0.2,0.4,3.1
E06000047,COUNTY DURHAM,263660,263325,96,56.7,54.8,52,53.6,0.3,0.7,1.1,3.8,0.2,99.2,0.9,253178,149450,144582,137087,141415,760,1752,3029,10147,531,261552,2340,108596,144582,760,992,1277,7118,41.2,54.8,0.3,0.4,0.5,2.7
E08000026,COVENTRY,151228,150819,98.8,96.5,96.5,94.8,96.5,0,0.2,0.5,1,0,98.8,0,149368,145912,145866,143305,145868,5,274,714,1451,5,149436,0,3502,145866,5,269,440,737,2.3,96.5,0,0.2,0.3,0.5
E07000163,CRAVEN,30811,30749,94.2,45.1,42.3,40,40.2,0.9,1.4,2.3,5.6,0.7,98.3,41.1,29011,13882,13032,12335,12400,271,437,701,1738,215,30287,12666,15979,13032,271,166,264,1037,51.9,42.3,0.9,0.5,0.9,3.4
E07000226,CRAWLEY,50241,50224,98.8,92.6,92.6,47.1,92.6,0,0.1,0.2,1.1,0,99.3,0,49653,46505,46505,23645,46505,25,37,108,571,4,49881,0,3148,46505,25,12,71,463,6.3,92.6,0,0,0.1,0.9
E09000008,CROYDON,171966,171823,96.7,86.7,86.7,46.2,86.7,0,0.1,0.4,3.2,0,97.1,0,166332,149113,149097,79486,149096,2,179,659,5491,5,166990,0,17235,149097,2,177,480,4832,10,86.7,0,0.1,0.3,2.8
E07000096,DACORUM,69899,69794,97.6,83.3,82.4,54.7,81.9,0.2,0.4,0.5,2.2,0.1,99.2,0,68254,58206,57592,38244,57280,151,270,363,1540,46,69351,0,10662,57592,151,119,93,1177,15.3,82.4,0.2,0.2,0.1,1.7
E06000005,DARLINGTON,55942,55768,95.9,87.5,87.3,50.1,87.1,0.7,1.8,2.3,3.8,0.1,97.2,15.4,53622,48938,48810,28052,48721,393,1011,1289,2146,54,54353,8597,4812,48810,393,618,278,857,8.6,87.3,0.7,1.1,0.5,1.5
E07000107,DARTFORD,51217,51203,98.3,77.1,75.7,42.3,74.3,0.1,0.2,0.3,1.7,0,99.4,0,50322,39495,38770,21661,38077,56,104,143,881,13,50912,0,11552,38770,56,48,39,738,22.6,75.7,0.1,0.1,0.1,1.4
W06000004,DENBIGHSHIRE,50501,50328,94.3,65.9,65.9,65.9,65.9,0.5,1.3,2.3,5.3,0.5,97,30,47638,33303,33303,33305,33305,255,665,1145,2690,248,48975,15165,14335,33303,255,410,480,1545,28.4,65.9,0.5,0.8,1,3.1
E06000015,DERBY,120844,120317,98.9,96,95.5,78,95.2,0,0.1,0.1,0.7,0,99,0,119517,115991,115445,94266,115009,0,61,169,800,0,119650,1,4072,115445,0,61,108,631,3.4,95.5,0,0.1,0.1,0.5
E07000035,DERBYSHIRE DALES,38500,38389,92.1,27.1,27.1,27.1,27.1,0.5,1.3,2.8,7.6,0.7,97.6,0,35474,10417,10417,10417,10417,180,501,1065,2915,268,37584,0,25057,10417,180,321,564,1850,65.1,27.1,0.5,0.8,1.5,4.8
N09000005,DERRY CITY AND STRABANE,67754,67637,95.9,90,90,88.2,90,0.9,1.4,1.9,4,0.9,99.2,0,64953,61000,61000,59760,61000,591,978,1285,2684,610,67225,0,3953,61000,591,387,307,1399,5.8,90,0.9,0.6,0.5,2.1
E08000017,DONCASTER,149531,149427,98.5,74.8,74.7,62.8,74.6,0.1,0.2,0.4,1.5,0,99.2,13.7,147251,111801,111636,93970,111520,89,294,671,2176,32,148345,20528,35615,111636,89,205,377,1505,23.8,74.7,0.1,0.1,0.3,1
E06000059,DORSET,193556,193257,95.8,41.7,41.6,39.6,41.6,0.1,0.4,0.8,4,0.2,99.2,3,185511,80626,80561,76564,80432,228,760,1486,7746,375,191963,5747,104950,80561,228,532,726,6260,54.2,41.6,0.1,0.3,0.4,3.2
E07000108,DOVER,56898,56857,95.4,66.4,66.4,45,66.4,0.5,0.7,1.2,4.5,0.1,98.7,33,54282,37779,37779,25625,37779,275,387,659,2575,79,56139,18772,16503,37779,275,112,272,1916,29,66.4,0.5,0.2,0.5,3.4
E08000027,DUDLEY,148171,148001,99,91.6,90.7,20.1,88.2,0,0,0.1,0.9,0,99.4,4.4,146717,135773,134320,29835,130617,1,12,76,1284,0,147251,6462,12397,134320,1,11,64,1208,8.4,90.7,0,0,0,0.8
S12000006,DUMFRIES AND GALLOWAY,83090,82921,89.8,23.9,23.9,23.9,23.9,1.2,2.7,4.8,10,1.7,97.4,0,74640,19898,19898,19897,19898,973,2232,4019,8281,1418,80901,11,54742,19898,973,1259,1787,4262,65.9,23.9,1.2,1.5,2.2,5.1
S12000042,DUNDEE CITY,80620,80557,98.9,94.1,92.8,69.1,92.1,0,0,0.1,1,0,99.3,0,79711,75836,74833,55699,74241,3,26,112,846,1,80023,0,4878,74833,3,23,86,734,6.1,92.8,0,0,0.1,0.9
E09000009,EALING,154337,154059,99.1,91.6,91.1,54.7,90.1,0,0.1,0.4,0.7,0,99.1,0,152929,141391,140665,84415,139098,3,189,568,1130,4,152939,0,12264,140665,3,186,379,562,7.9,91.1,0,0.1,0.2,0.4
S12000008,EAST AYRSHIRE,62412,62308,97.4,64.2,63.6,59,63.3,0.4,0.7,1.1,2.5,0.1,99.1,0,60766,40073,39715,36841,39524,221,410,712,1542,89,61878,0,21051,39715,221,189,302,830,33.7,63.6,0.4,0.3,0.5,1.3
E07000009,EAST CAMBRIDGESHIRE,41405,41325,97.1,73.4,71.3,64.5,70.4,0.3,0.7,1,2.7,0.2,99.3,1.3,40201,30386,29534,26706,29151,140,271,433,1124,71,41113,535,10667,29534,140,131,162,691,25.8,71.3,0.3,0.3,0.4,1.7
E07000040,EAST DEVON,77341,77243,92.5,63.6,63.3,63.1,63.2,0.3,1.2,2.4,7.4,0.3,97.2,14.8,71539,49218,48947,48797,48849,219,917,1883,5704,250,75200,11485,22592,48947,219,698,966,3821,29.2,63.3,0.3,0.9,1.2,4.9
S12000045,EAST DUNBARTONSHIRE,50506,50429,97.6,88.4,87.9,48.6,87.6,0.1,0.2,0.4,2.3,0,99,0,49280,44659,44419,24527,44262,65,118,187,1149,12,49976,0,4861,44419,65,53,69,962,9.6,87.9,0.1,0.1,0.1,1.9
E07000085,EAST HAMPSHIRE,59007,58859,94.8,63.7,62.9,42.6,61.9,0.2,0.5,1,5,0.2,98.4,0,55929,37590,37122,25152,36528,109,296,563,2930,128,58046,0,18807,37122,109,187,267,2367,31.9,62.9,0.2,0.3,0.5,4
E07000242,EAST HERTFORDSHIRE,68684,68573,96.6,76.9,74,21.6,71.3,0.1,0.3,0.6,3.2,0.2,98.4,0,66341,52803,50793,14809,48980,62,185,392,2232,113,67595,3,15548,50793,62,123,207,1840,22.6,74,0.1,0.2,0.3,2.7
E07000137,EAST LINDSEY,74186,74098,89.4,38.1,37.3,29.2,36.4,0.8,2.6,4.3,10.4,0.5,97.6,56.7,66354,28269,27638,21636,27040,624,1917,3205,7744,379,72400,42062,38716,27638,624,1293,1288,4539,52.2,37.3,0.8,1.7,1.7,6.1
S12000010,EAST LOTHIAN,52349,52245,95.1,71.4,71.4,71.4,71.4,0.5,1.4,2.2,4.7,0.2,98.1,34.4,49808,37397,37397,37395,37397,257,707,1174,2437,114,51344,17986,12411,37397,257,450,467,1263,23.7,71.4,0.5,0.9,0.9,2.4
S12000011,EAST RENFREWSHIRE,42146,42127,97,80.7,80.3,42.6,80.3,0.1,0.2,0.6,2.9,0.1,99.1,0,40887,34009,33856,17941,33828,33,69,265,1240,41,41771,0,7031,33856,33,36,196,975,16.7,80.3,0.1,0.1,0.5,2.3
E06000011,EAST RIDING OF YORKSHIRE,170760,170104,97,78.7,78.4,78.3,78.3,0.4,0.7,1.1,2.6,0.2,98.8,31.7,165595,134446,133959,133680,133682,623,1258,1933,4509,348,168708,54205,31636,133959,623,635,675,2576,18.5,78.4,0.4,0.4,0.4,1.5
E07000193,EAST STAFFORDSHIRE,57275,57073,96.1,53.4,50.6,47,48.6,0.3,0.7,1.1,3.6,0.2,99.2,0,55030,30572,28986,26908,27821,180,426,632,2043,111,56793,0,26044,28986,180,246,206,1411,45.5,50.6,0.3,0.4,0.4,2.5
E07000244,EAST SUFFOLK,128665,128084,96.4,48.3,48.2,42.3,48.2,0.1,0.5,0.9,3.1,0.2,98.7,4.3,124052,62087,62071,54416,62069,175,616,1127,4032,313,126944,5547,61981,62071,175,441,511,2905,48.2,48.2,0.1,0.3,0.4,2.3
E07000061,EASTBOURNE,51311,51284,99.7,77.3,77.3,77.3,77.3,0,0,0,0.3,0,99.7,0,51154,39675,39675,39675,39675,0,4,19,130,1,51179,0,11479,39675,0,4,15,111,22.4,77.3,0,0,0,0.2
E07000086,EASTLEIGH,62349,62313,98,79.7,77.6,25,76.3,0,0.1,0.2,1.9,0,99.2,0,61129,49711,48356,15600,47582,0,40,112,1184,0,61876,0,12773,48356,0,40,72,1072,20.5,77.6,0,0.1,0.1,1.7
E07000030,EDEN,30704,30603,85.9,40.3,40.3,40.3,40.3,3.3,6,7.9,13.8,1.2,96.8,10.6,26373,12366,12366,12366,12366,1018,1828,2425,4230,371,29708,3254,14007,12366,1018,810,597,1805,45.6,40.3,3.3,2.6,1.9,5.9
E07000207,ELMBRIDGE,61741,61708,98.9,83.6,81.4,37.7,79.7,0,0.1,0.1,1,0,99.5,0,61086,51603,50271,23301,49194,29,44,79,622,0,61429,0,10815,50271,29,15,35,543,17.5,81.4,0,0,0.1,0.9
E09000010,ENFIELD,134571,133828,97.7,88.7,87.9,9.7,87.3,0,0.1,0.8,1.8,0,97.9,0,131419,119337,118285,13004,117436,24,123,1070,2409,17,131792,0,13134,118285,24,99,947,1339,9.8,87.9,0,0.1,0.7,1
E07000072,EPPING FOREST,61790,61767,97.1,87,85.8,53.6,84.4,0.1,0.3,0.6,2.9,0.1,98.1,0.4,59995,53766,53000,33119,52150,81,186,395,1772,40,60645,223,6995,53000,81,105,209,1377,11.3,85.8,0.1,0.2,0.3,2.2
E07000208,EPSOM AND EWELL,33644,33642,99.8,93.1,92.9,77.6,92.9,0,0,0,0.2,0,99.9,0,33572,31310,31269,26108,31252,1,5,5,70,0,33603,0,2303,31269,1,4,0,65,6.8,92.9,0,0,0,0.2
E07000036,EREWASH,56411,56303,98.4,83.7,82.4,45.4,81.4,0.3,0.3,0.4,1.4,0,99.5,0,55528,47234,46472,25584,45912,157,195,237,775,5,56153,0,9056,46472,157,38,42,538,16.1,82.4,0.3,0.1,0.1,1
E07000041,EXETER,61014,60781,97,89.6,89.6,72.1,89.6,0,0.1,0.9,2.6,0,97.3,33.9,59169,54655,54655,44010,54655,11,54,526,1612,1,59386,20673,4514,54655,11,43,472,1086,7.4,89.6,0,0.1,0.8,1.8
S12000014,FALKIRK,75325,75315,97.4,88.8,88.7,17.7,88.7,0.1,0.3,0.8,2.6,0.1,98.9,0,73362,66858,66803,13330,66780,56,263,582,1953,67,74470,0,6559,66803,56,207,319,1371,8.7,88.7,0.1,0.3,0.4,1.8
E07000087,FAREHAM,52879,52850,98.8,89.1,86.5,38,85,0.1,0.1,0.2,1.2,0,99.7,0,52238,47092,45719,20105,44928,46,76,119,612,1,52730,0,6519,45719,46,30,43,493,12.3,86.5,0.1,0.1,0.1,0.9
E07000010,FENLAND,48959,48923,96.6,74,74,57.4,74,0.3,0.7,1,3.3,0.2,99.1,0,47301,36222,36216,28109,36216,130,344,514,1622,98,48507,21,11085,36216,130,214,170,1108,22.6,74,0.3,0.4,0.3,2.3
N09000006,FERMANAGH AND OMAGH,54651,54184,91.9,80.9,80.9,80.9,80.9,2.5,3.8,4.8,7.2,1.2,98.7,39.3,50237,44188,44188,44188,44188,1343,2061,2616,3947,664,53965,21458,6049,44188,1343,718,555,1331,11.1,80.9,2.5,1.3,1,2.4
S12000047,FIFE,194701,193485,96.6,70.2,70.1,49.9,70,0.2,0.6,1,2.8,0.1,98.8,0,188031,136736,136435,97238,136319,457,1109,1882,5454,270,192438,0,51596,136435,457,652,773,3572,26.5,70.1,0.2,0.3,0.4,1.8
W06000005,FLINTSHIRE,75541,75422,96.6,71.9,67.6,65,65,0.3,0.8,1.4,3.2,0.2,98.5,38.8,72989,54334,51049,49127,49127,215,571,1078,2433,157,74400,29298,21940,51049,215,356,507,1355,29,67.6,0.3,0.5,0.7,1.8
E07000112,FOLKESTONE AND HYTHE,55380,55169,94.7,65,64.9,45.9,64.9,0.7,1.2,2,4.9,0.1,97.9,12.5,52472,35984,35923,25408,35923,361,643,1103,2697,48,54221,6929,16549,35923,361,282,460,1594,29.9,64.9,0.7,0.5,0.8,2.9
E07000080,FOREST OF DEAN,42591,42425,87.3,49.1,48,47.2,47.2,0.5,2.4,5.4,12.3,0.9,91.6,0.4,37176,20903,20430,20110,20114,231,1021,2285,5249,370,39033,152,16746,20430,231,790,1264,2964,39.3,48,0.5,1.9,3,7
E07000119,FYLDE,37195,37059,97.5,84.2,82.4,61.9,81.2,0.1,0.3,0.6,2.1,0,99.3,2.1,36282,31305,30655,23023,30212,21,99,240,777,1,36924,765,5627,30655,21,78,141,537,15.1,82.4,0.1,0.2,0.4,1.4
E08000037,GATESHEAD,101970,101835,96.5,75.1,74.2,18.9,73.3,0.1,0.4,1.1,3.4,0,97.8,0,98351,76609,75667,19299,74782,91,384,1088,3484,12,99764,2,22684,75667,91,293,704,2396,22.2,74.2,0.1,0.3,0.7,2.3
E07000173,GEDLING,56383,56353,99,92,91.7,68.6,91.5,0.1,0.2,0.3,0.9,0,99.8,1.5,55822,51861,51679,38653,51589,32,116,144,531,21,56286,851,4143,51679,32,84,28,387,7.3,91.7,0.1,0.1,0,0.7
S12000049,GLASGOW CITY,340474,339453,97.6,86.6,83.4,61.4,80.4,0,0.1,0.2,2.1,0,97.8,0,332420,294799,283851,209022,273650,19,184,664,7033,5,333105,0,48569,283851,19,165,480,6369,14.3,83.4,0,0,0.1,1.9
E07000081,GLOUCESTER,61329,61285,99,92,91.9,33.9,91.9,0,0.2,0.3,0.9,0,99.3,0,60736,56395,56340,20762,56340,3,123,197,549,2,60922,0,4396,56340,3,120,74,352,7.2,91.9,0,0.2,0.1,0.6
E07000088,GOSPORT,39261,39247,99.7,87.7,87.7,17.4,87.5,0,0,0,0.3,0,99.9,0,39135,34434,34420,6817,34373,10,12,16,112,0,39228,0,4715,34420,10,2,4,96,12,87.7,0,0,0,0.2
E07000109,GRAVESHAM,46216,46111,97.4,83.3,80.5,61.9,76.9,0,0.3,0.4,2.4,0.1,98.8,0,44995,38507,37223,28594,35531,21,133,193,1116,41,45683,0,7772,37223,21,112,60,923,16.8,80.5,0,0.2,0.1,2
E07000145,GREAT YARMOUTH,49963,49862,98.1,62.6,62.6,23,62.6,0,0.1,0.2,1.7,0.1,99.5,0,49035,31289,31289,11478,31289,8,40,102,827,37,49724,1,17746,31289,8,32,62,725,35.5,62.6,0,0.1,0.1,1.5
E09000011,GREENWICH,127206,127153,99,87.4,85.9,61.1,84.9,0,0.1,0.3,1,0,99.1,0,125940,111188,109211,77701,107999,0,168,329,1213,2,126017,1,16729,109211,0,168,161,884,13.2,85.9,0,0.1,0.1,0.7
E07000209,GUILDFORD,60356,60291,97.2,76.6,73.6,27.3,70.8,0,0.2,0.5,2.7,0.1,99.1,0,58642,46254,44435,16504,42707,22,104,325,1649,66,59818,0,14207,44435,22,82,221,1324,23.5,73.6,0,0.1,0.4,2.2
W06000002,GWYNEDD,68484,68256,92,38.8,37.2,36.4,36.4,0.9,2,3.7,7.7,1.1,95.7,17.4,63002,26557,25504,24939,24941,627,1391,2547,5254,780,65539,11924,37498,25504,627,764,1156,2707,54.8,37.2,0.9,1.1,1.7,4
E09000012,HACKNEY,128277,127748,97.8,82.8,79.8,51.5,78.3,0,0,0.2,1.8,0.2,97.8,0,125408,106276,102359,66027,100439,0,62,255,2340,237,125482,0,23049,102359,0,62,193,2085,18,79.8,0,0,0.2,1.6
E06000006,HALTON,61947,61777,98.3,74.4,73.8,17.1,73.5,0,0.1,0.2,1.4,0,99.4,0,60924,46070,45705,10584,45519,28,79,154,853,0,61554,0,15219,45705,28,51,75,699,24.6,73.8,0,0.1,0.1,1.1
E07000164,HAMBLETON,45990,45924,92.3,54.6,54.5,54.4,54.4,1.1,2.5,3.7,7.6,0.6,98.6,52.6,42450,25108,25051,25023,25027,517,1142,1693,3474,255,45329,24201,17399,25051,517,625,551,1781,37.8,54.5,1.1,1.4,1.2,3.9
E09000013,HAMMERSMITH AND FULHAM,94640,93887,96.6,88.5,83.7,69.5,78.9,0,0.1,0.2,2.6,0,96.6,0,91444,83715,79207,65738,74677,0,50,235,2443,0,91448,0,12237,79207,0,50,185,2208,12.9,83.7,0,0.1,0.2,2.3
E07000131,HARBOROUGH,45180,45118,96.2,56.3,52,37.2,49.4,0.3,0.5,1.2,3.6,0.4,98.9,0,43485,25440,23506,16798,22325,136,244,535,1633,159,44661,0,19979,23506,136,108,291,1098,44.2,52,0.3,0.2,0.6,2.4
E09000014,HARINGEY,112646,112542,98.7,85.9,84.8,17.3,82.9,0,0,0.2,1.2,0,98.7,0,111170,96810,95497,19474,93407,0,21,244,1372,0,111232,0,15673,95497,0,21,223,1128,13.9,84.8,0,0,0.2,1
E07000073,HARLOW,42364,42327,97.4,91.8,90.7,10.9,89.7,0,0.1,0.9,2.5,0,97.6,0,41253,38907,38431,4597,38021,2,31,361,1074,1,41347,1,2822,38431,2,29,330,713,6.7,90.7,0,0.1,0.8,1.7
E07000165,HARROGATE,80925,80841,95,68.5,67.9,62.7,67.2,0.6,1.3,1.8,4.9,0.4,98.7,28.9,76869,55466,54979,50712,54383,489,1027,1442,3972,284,79883,23370,21890,54979,489,538,415,2530,27,67.9,0.6,0.7,0.5,3.1
E09000015,HARROW,100864,100636,98,82.3,82.3,24.7,81.4,0,0,0.5,1.7,0,98.1,0,98892,83024,83016,24879,82094,2,42,516,1744,8,98971,0,15876,83016,2,40,474,1228,15.7,82.3,0,0,0.5,1.2
E07000089,HART,43857,43729,96.6,73.3,73.3,31.9,73.3,0.1,0.3,0.5,3.1,0.1,99.2,0,42382,32168,32168,13998,32168,25,115,223,1347,43,43523,0,10214,32168,25,90,108,1124,23.3,73.3,0.1,0.2,0.2,2.6
E06000001,HARTLEPOOL,47648,47582,97.2,90.5,90.5,19.1,90.5,0.3,0.6,1.1,2.7,0,97.8,0.1,46314,43136,43136,9079,43136,155,273,504,1268,7,46596,60,3178,43136,155,118,231,764,6.7,90.5,0.3,0.2,0.5,1.6
E07000062,HASTINGS,46382,46339,99.4,32.4,32.4,32.4,32.4,0,0,0.1,0.5,0,99.9,0,46088,15030,15030,15030,15030,0,5,27,251,0,46326,0,31058,15030,0,5,22,224,67,32.4,0,0,0,0.5
E07000090,HAVANT,58970,58878,99.2,87.6,87.6,15.6,87.5,0,0.1,0.1,0.6,0,99.5,0,58495,51634,51629,9178,51616,0,48,56,383,0,58673,7,6866,51629,0,48,8,327,11.6,87.6,0,0.1,0,0.6
E09000016,HAVERING,113430,113216,97.6,87.7,86.3,22.6,85.1,0,0.2,0.5,2.2,0.2,98.3,0,110750,99497,97862,25681,96527,53,177,527,2466,184,111506,0,12888,97862,53,124,350,1939,11.4,86.3,0,0.1,0.3,1.7
E06000019,"HEREFORDSHIRE, COUNTY OF",92624,92494,92.7,69.7,64.4,68.4,68.4,0.6,1.5,2.7,7.1,0.8,97.2,2.7,85894,64540,59691,63331,63331,575,1430,2507,6600,781,90010,2538,26203,59691,575,855,1077,4093,28.3,64.4,0.6,0.9,1.2,4.4
E07000098,HERTSMERE,47318,47291,98.2,84.9,82.9,15,80.4,0,0.2,0.3,1.7,0,99,0,46466,40154,39243,7097,38043,4,85,146,825,0,46829,0,7223,39243,4,81,61,679,15.3,82.9,0,0.2,0.1,1.4
E07000037,HIGH PEAK,47004,46886,94.4,19.1,16.3,13.4,13.4,0.4,0.7,1,5.3,0.2,98.9,0,44385,8958,7682,6291,6291,188,317,493,2501,115,46471,0,36703,7682,188,129,176,2008,78.1,16.3,0.4,0.3,0.4,4.3
S12000017,HIGHLAND,120580,119059,84.7,34,34,34,34,2.1,4.1,7.1,14.1,2.3,93.5,4.5,102076,41052,41052,41052,41052,2568,4964,8523,16983,2808,112706,5481,61024,41052,2568,2396,3559,8460,50.6,34,2.1,2,3,7
E09000017,HILLINGDON,122045,121823,97.5,90,89.1,46.4,88.4,0,0.1,0.7,2.3,0,97.7,0,119018,109851,108789,56630,107827,44,153,815,2805,7,119249,0,10229,108789,44,109,662,1990,8.4,89.1,0,0.1,0.5,1.6
E07000132,HINCKLEY AND BOSWORTH,55583,55365,98,68.3,65.9,23.9,63.5,0,0.2,0.4,1.6,0.1,99.4,0,54493,37974,36611,13297,35313,23,100,205,872,33,55235,0,17882,36611,23,77,105,667,32.2,65.9,0,0.1,0.2,1.2
E07000227,HORSHAM,68673,68548,95.2,57.4,54.9,52.9,52.9,0.3,0.7,1.3,4.6,0.4,99.3,0,65391,39447,37690,36313,36316,180,515,859,3157,261,68204,0,27701,37690,180,335,344,2298,40.3,54.9,0.3,0.5,0.5,3.3
E09000018,HOUNSLOW,104015,103799,97.6,88.1,88,38.3,87.5,0,0.1,0.5,2.2,0,97.7,0,101506,91625,91521,39811,91010,3,122,517,2293,9,101583,0,9985,91521,3,119,395,1776,9.6,88,0,0.1,0.4,1.7
E07000011,HUNTINGDONSHIRE,85832,85401,97.3,71.8,68.9,43.3,67.1,0.2,0.5,0.8,2.2,0.2,99,0,83540,61589,59162,37132,57624,140,398,719,1861,138,84937,11,24378,59162,140,258,321,1142,28.4,68.9,0.2,0.3,0.4,1.3
E07000120,HYNDBURN,41463,41371,98.5,90.2,89.1,83.1,88,0,0.1,0.2,1.2,0,99.7,47,40858,37380,36926,34445,36486,15,34,70,513,1,41354,19486,3932,36926,15,19,36,443,9.5,89.1,0,0,0.1,1.1
S12000018,INVERCLYDE,41976,41929,96.8,75,75,19.3,75,0.1,0.4,0.7,3,0.1,98.4,0,40649,31502,31502,8088,31502,34,154,295,1280,32,41317,0,9147,31502,34,120,141,985,21.8,75,0.1,0.3,0.3,2.3
E07000202,IPSWICH,65685,65520,99,94.7,93.6,80.9,92.2,0,0.1,0.2,0.8,0,99.1,0,65007,62185,61486,53135,60558,0,44,149,513,1,65072,0,3521,61486,0,44,105,364,5.4,93.6,0,0.1,0.2,0.6
W06000001,ISLE OF ANGLESEY,37860,37749,93.1,24.3,24.2,24.3,24.3,0.7,1.5,2.7,6.6,0.8,97.5,24.8,35238,9201,9175,9201,9201,258,584,1006,2511,301,36906,9385,26063,9175,258,326,422,1505,68.8,24.2,0.7,0.9,1.1,4
E06000046,ISLE OF WIGHT,78803,78471,95.2,65,65,65,65,0.3,0.7,1.1,4.4,0.2,99.3,0,75041,51202,51202,51202,51202,201,515,853,3430,162,78281,0,23839,51202,201,314,338,2577,30.3,65,0.3,0.4,0.4,3.3
E06000053,ISLES OF SCILLY,1689,1678,97.7,1.8,1.8,1.8,1.8,0,0,0.1,1.7,0.1,99.3,0,1650,31,31,31,31,0,0,2,28,2,1678,0,1619,31,0,0,2,26,95.9,1.8,0,0,0.1,1.5
E09000019,ISLINGTON,119439,119176,96.8,89.2,89.2,51,89.2,0,0,0,3,0,96.8,0,115636,106489,106486,60880,106487,0,0,23,3540,0,115642,0,9150,106486,0,0,23,3517,7.7,89.2,0,0,0,2.9
E09000020,KENSINGTON AND CHELSEA,98100,97924,97.6,92.2,91.1,53.9,89.5,0,0,0.2,2.3,0,97.6,0,95697,90403,89386,52850,87778,0,0,235,2227,0,95698,0,6311,89386,0,0,235,1992,6.4,91.1,0,0,0.2,2
E07000146,KING'S LYNN AND WEST NORFOLK,79310,79119,94.6,46,44.8,43.9,44.2,0.4,0.9,1.5,5.1,0.4,98.5,0,75059,36473,35558,34826,35039,305,682,1152,4060,313,78135,12,39501,35558,305,377,470,2908,49.8,44.8,0.4,0.5,0.6,3.7
E06000010,"KINGSTON UPON HULL, CITY OF",130120,128360,98.6,98.4,98.4,98.4,98.4,0,0,0,0,0,98.6,17.4,128306,128073,128073,128073,128073,0,0,24,54,5,128306,22596,233,128073,0,0,24,30,0.2,98.4,0,0,0,0
E09000021,KINGSTON UPON THAMES,71324,71262,98.3,91.2,89.4,26.3,87.6,0,0,0.1,1.6,0,98.6,0,70132,65076,63759,18723,62458,0,20,85,1130,1,70338,0,6373,63759,0,20,65,1045,8.9,89.4,0,0,0.1,1.5
E08000034,KIRKLEES,200513,200102,97.8,81.4,81.4,61.2,81.4,0.1,0.2,0.4,2,0,99.1,49.6,196175,163120,163120,122779,163120,124,498,796,3927,17,198641,99466,33055,163120,124,374,298,3131,16.5,81.4,0.1,0.2,0.1,1.6
E08000011,KNOWSLEY,73929,73852,99,91.6,91.6,72,91.6,0,0.1,0.2,0.9,0,99.5,2.5,73196,67686,67686,53262,67686,23,93,144,656,10,73574,1830,5510,67686,23,70,51,512,7.5,91.6,0,0.1,0.1,0.7
E09000022,LAMBETH,156007,155582,97.9,87.8,85.9,59.2,84.3,0,0,0,1.8,0,98,0,152698,136930,134088,92340,131471,0,0,8,2884,3,152816,0,18610,134088,0,0,8,2876,11.9,85.9,0,0,0,1.8
E07000121,LANCASTER,68599,68490,98,81.7,79.5,69.5,78.5,0.3,0.4,0.6,1.8,0.1,99.5,1.9,67252,56059,54549,47696,53871,173,256,385,1238,39,68277,1336,12703,54549,173,83,129,853,18.5,79.5,0.3,0.1,0.2,1.2
E08000035,LEEDS,384399,383822,97.3,91.9,91.5,79.8,91,0,0.2,0.3,2.6,0,97.7,16.1,373850,353427,351536,306857,349619,112,660,1201,9972,99,375563,61764,22314,351536,112,548,541,8771,5.8,91.5,0,0.1,0.1,2.3
E06000016,LEICESTER,147057,146948,99.4,95.9,95.5,70.4,95.4,0,0,0,0.5,0,99.4,0,146177,141057,140400,103480,140311,16,28,71,771,0,146224,0,5777,140400,16,12,43,700,3.9,95.5,0,0,0,0.5
E07000063,LEWES,48510,48486,98.1,54.6,54.6,54.5,54.6,0.1,0.2,0.3,1.9,0.1,99.8,0,47573,26477,26477,26445,26477,27,92,162,913,26,48398,0,21096,26477,27,65,70,751,43.5,54.6,0.1,0.1,0.1,1.5
E09000023,LEWISHAM,140473,139105,96.5,79.9,79.2,51,78.6,0,0,0.3,2.6,0,96.6,0,135491,112215,111299,71635,110419,1,1,397,3614,0,135731,0,24192,111299,1,0,396,3217,17.2,79.2,0,0,0.3,2.3
E07000194,LICHFIELD,50233,50184,96.5,77.5,75.5,48.3,73.6,0.2,0.5,1,3.4,0.1,99.5,0,48471,38949,37932,24271,36972,117,274,508,1713,40,49983,0,10539,37932,117,157,234,1205,21,75.5,0.2,0.3,0.5,2.4
E07000138,LINCOLN,49020,48787,97.9,85.4,85.3,34.9,85.4,0,0,0.4,1.6,0,98.2,81.9,48010,41879,41820,17113,41879,2,17,196,777,0,48126,40140,6190,41820,2,15,179,581,12.6,85.3,0,0,0.4,1.2
N09000007,LISBURN AND CASTLEREAGH,66283,66065,97.9,92.4,92.4,90,92.4,0.1,0.5,0.7,1.7,0.2,99.4,0,64915,61226,61226,59675,61226,65,323,481,1150,131,65917,0,3689,61226,65,258,158,669,5.6,92.4,0.1,0.4,0.2,1
E08000012,LIVERPOOL,236122,235012,95.8,86.6,84.8,55.2,83.7,0,0,0.3,3.7,0,96,0,226184,204548,200146,130281,197594,29,61,700,8828,1,226773,0,26038,200146,29,32,639,8128,11,84.8,0,0,0.3,3.4
E06000032,LUTON,87542,87421,99.4,94.9,93.3,18.3,92.1,0,0.1,0.1,0.5,0,99.5,0,86994,83053,81700,16062,80623,8,87,112,427,0,87104,0,5294,81700,8,79,25,315,6,93.3,0,0.1,0,0.4
E07000110,MAIDSTONE,81328,81138,94.6,76.7,73.4,50.1,70.8,0.4,0.7,1.3,5.2,0.3,98.4,28.6,76942,62375,59735,40731,57611,292,596,1025,4196,231,80042,23265,17207,59735,292,304,429,3171,21.2,73.4,0.4,0.4,0.5,3.9
E07000074,MALDON,31119,31038,97.5,70.6,70.6,70.6,70.6,0.1,0.4,0.8,2.3,0.2,99.5,5,30328,21964,21964,21964,21964,40,114,251,710,48,30977,1564,8364,21964,40,74,137,459,26.9,70.6,0.1,0.2,0.4,1.5
E07000235,MALVERN HILLS,39373,39314,94.2,57,54.2,54.1,54.1,0.3,1.2,2.1,5.6,0.3,98.8,5.3,37104,22447,21329,21302,21302,136,476,833,2210,134,38883,2073,15775,21329,136,340,357,1377,40.1,54.2,0.3,0.9,0.9,3.5
E08000003,MANCHESTER,253617,248632,93.9,81.1,79,49,77.5,0,0.2,0.8,4.1,0,94.1,0,238196,205697,200335,124151,196445,23,502,1980,10436,0,238721,0,37861,200335,23,479,1478,8456,14.9,79,0,0.2,0.6,3.3
E07000174,MANSFIELD,53846,53816,99,89.1,87.2,14.1,85.5,0,0,0.1,1,0,99.6,0,53286,47973,46947,7572,46056,7,23,58,530,3,53618,0,6339,46947,7,16,35,472,11.8,87.2,0,0,0.1,0.9
E06000035,MEDWAY,124329,124208,97.9,88.2,86.2,60.6,83.2,0.1,0.4,0.6,2,0.1,98.9,2.8,121726,109658,107171,75286,103451,80,439,789,2482,70,122944,3512,14555,107171,80,359,350,1693,11.7,86.2,0.1,0.3,0.3,1.4
E07000133,MELTON,25315,25211,94.2,48.1,47.8,4.6,47.6,0.7,1.4,2.5,5.4,0.9,97.5,4.1,23850,12172,12088,1174,12052,175,366,638,1361,225,24685,1038,11762,12088,175,191,272,723,46.5,47.8,0.7,0.8,1.1,2.9
E07000187,MENDIP,56574,56494,90.8,74.1,72.4,60.7,70.9,0.4,1.4,3.5,9.1,0.3,96.1,12.4,51357,41897,40949,34356,40122,200,775,1968,5137,170,54381,6995,10408,40949,200,575,1193,3169,18.4,72.4,0.4,1,2.1,5.6
W06000024,MERTHYR TYDFIL,28674,28650,99,65.2,65.2,65.2,65.2,0.1,0.2,0.3,0.9,0,99.7,10.1,28397,18688,18688,18688,18688,21,50,78,253,5,28590,2890,9709,18688,21,29,28,175,33.9,65.2,0.1,0.1,0.1,0.6
E09000024,MERTON,91358,91326,99.1,91.1,91.1,57.5,89.7,0,0,0.1,0.8,0,99.2,0,90573,83247,83227,52550,81989,0,12,78,753,3,90596,0,7346,83227,0,12,66,675,8,91.1,0,0,0.1,0.7
N09000008,MID AND EAST ANTRIM,65870,65413,95.4,89,89,89,89,0.8,1.5,2,3.9,0.3,98.9,0,62840,58615,58615,58613,58615,534,986,1332,2573,207,65173,0,4225,58615,534,452,346,1241,6.4,89,0.8,0.7,0.5,1.9
E07000042,MID DEVON,38273,38175,84.3,40.8,38.3,40.8,40.8,1.4,4.2,7.2,15.4,1.2,94.1,11.4,32282,15624,14676,15620,15624,545,1590,2738,5893,466,35999,4380,17606,14676,545,1045,1148,3155,46,38.3,1.4,2.7,3,8.2
E07000203,MID SUFFOLK,50877,50776,95.6,42.7,41.6,41.1,41.1,0.2,0.6,1.2,4.2,0.3,99.2,3.6,48646,21747,21178,20888,20893,123,284,586,2130,153,50447,1813,27468,21178,123,161,302,1544,54,41.6,0.2,0.3,0.6,3
E07000228,MID SUSSEX,71011,70959,97.3,62.3,62.1,61.8,61.8,0,0.1,0.5,2.6,0.1,99.5,0,69122,44230,44076,43857,43883,22,97,325,1837,105,70670,0,25046,44076,22,75,228,1512,35.3,62.1,0,0.1,0.3,2.1
N09000009,MID ULSTER,62607,62072,95.2,84.6,84.6,84.6,84.6,0.7,1.2,1.9,4,1,98.8,4.3,59599,52995,52995,52994,52995,426,775,1178,2473,638,61859,2671,6604,52995,426,349,403,1295,10.5,84.6,0.7,0.6,0.6,2.1
E06000002,MIDDLESBROUGH,69421,69269,98,94.2,94.2,25.3,94.2,0,0.3,0.6,1.8,0,98.2,0.2,68020,65369,65369,17584,65369,20,193,449,1249,19,68183,117,2651,65369,20,173,256,800,3.8,94.2,0,0.2,0.4,1.2
S12000019,MIDLOTHIAN,44248,44215,98.2,80.6,80.6,80.6,80.6,0.1,0.5,0.9,1.7,0.2,99.3,4.5,43451,35673,35673,35671,35673,66,218,380,764,74,43951,1981,7778,35673,66,152,162,384,17.6,80.6,0.1,0.3,0.4,0.9
E06000042,MILTON KEYNES,128126,127942,98.5,91.4,90.5,89.7,89.8,0.1,0.3,0.8,1.3,0,99.1,0,126265,117077,115940,114979,114997,71,384,975,1677,35,126931,1,10325,115940,71,313,591,702,8.1,90.5,0.1,0.2,0.5,0.5
E07000210,MOLE VALLEY,40460,40433,96.6,69.3,69.3,29,69.3,0,0.2,0.5,3.3,0.2,99.5,0,39087,28039,28039,11739,28039,19,65,205,1346,71,40255,0,11048,28039,19,46,140,1141,27.3,69.3,0,0.1,0.3,2.8
W06000021,MONMOUTHSHIRE,46366,46215,91.1,55.2,51.1,47.9,47.9,1,2.3,4.2,8.6,1.4,97,0,42227,25617,23684,22229,22229,442,1064,1965,3988,670,44979,15,18543,23684,442,622,901,2023,40,51.1,1,1.3,1.9,4.4
S12000020,MORAY,50550,50180,86,47.4,47.4,47.4,47.4,1.4,3.8,6.4,13.2,2.1,95.4,34.3,43494,23966,23966,23966,23966,703,1908,3251,6686,1041,48203,17348,19528,23966,703,1205,1343,3435,38.6,47.4,1.4,2.4,2.7,6.8
S12000013,NA H-EILEANAN SIAR,17023,15796,78.3,5.6,5.6,5.6,5.6,2.2,3.3,5,14.4,3.3,89.3,0,13337,961,961,961,961,376,561,859,2459,559,15194,0,12376,961,376,185,298,1600,72.7,5.6,2.2,1.1,1.8,9.4
W06000012,NEATH PORT TALBOT,69285,69185,97.8,69.3,69.3,30.2,69.3,0.1,0.2,0.4,2.1,0.1,99.2,32.4,67746,47989,47989,20939,47989,65,132,245,1439,48,68760,22441,19757,47989,65,67,113,1194,28.5,69.3,0.1,0.1,0.2,1.7
E07000091,NEW FOREST,87974,87900,95.2,38.6,37.2,28.2,36.3,0.4,0.6,0.9,4.7,0.4,99.4,0,83746,33982,32705,24818,31920,326,547,818,4154,339,87458,17,51041,32705,326,221,271,3336,58,37.2,0.4,0.3,0.3,3.8
E07000175,NEWARK AND SHERWOOD,60887,60768,96.9,64.3,64.2,32.1,64.1,0.3,0.6,1.1,2.9,0.1,99.2,22.5,58977,39126,39088,19524,39041,170,381,687,1791,88,60412,13671,19889,39088,170,211,306,1104,32.7,64.2,0.3,0.3,0.5,1.8
E08000021,NEWCASTLE UPON TYNE,142230,142005,97.3,83.7,81.9,62.4,80.6,0,0.1,0.4,2.5,0,97.8,0,138441,118977,116488,88803,114678,56,130,525,3564,1,139110,56,21953,116488,56,74,395,3039,15.4,81.9,0,0.1,0.3,2.1
E07000195,NEWCASTLE-UNDER-LYME,61518,61332,97.4,72.5,71.9,35.1,71.5,0.1,0.3,0.6,2.3,0.1,99.3,2,59921,44617,44223,21623,43960,37,166,357,1411,36,61090,1245,15698,44223,37,129,191,1054,25.5,71.9,0.1,0.2,0.3,1.7
E09000025,NEWHAM,132903,132586,98.4,91.5,88.6,66.5,85.6,0,0.1,0.5,1.3,0,98.4,0,130798,121616,117734,88416,113757,30,134,705,1788,19,130806,0,13064,117734,30,104,571,1083,9.8,88.6,0,0.1,0.4,0.8
W06000022,NEWPORT,73802,73649,98,83.8,82.5,51.3,81.6,0.1,0.3,0.6,1.8,0.1,98.6,33.4,72293,61874,60890,37889,60198,56,215,420,1356,83,72741,24631,11403,60890,56,159,205,936,15.5,82.5,0.1,0.2,0.3,1.3
N09000010,"NEWRY, MOURNE AND DOWN",78036,77278,97,89.9,89.9,89.9,89.9,0.4,0.7,1,2,0.6,98.9,3.8,75687,70139,70139,70138,70139,334,557,800,1591,442,77204,2975,5548,70139,334,223,243,791,7.1,89.9,0.4,0.3,0.3,1
S12000021,NORTH AYRSHIRE,73288,73188,96.4,60,60,45.8,60,0.3,0.7,1.1,3.4,0.2,99.2,0,70678,43952,43952,33546,43952,218,502,795,2510,150,72730,0,26726,43952,218,284,293,1715,36.5,60,0.3,0.4,0.4,2.3
E07000043,NORTH DEVON,52864,52734,92,56.3,45.4,56.3,56.3,1.2,2.5,4,7.7,0.7,96.4,51.6,48650,29775,23985,29775,29775,634,1297,2101,4084,367,50982,27279,24665,23985,634,663,804,1983,46.7,45.4,1.2,1.3,1.5,3.8
E07000038,NORTH EAST DERBYSHIRE,49930,49893,96.2,60.3,59.8,58.4,59.3,0.2,0.5,0.9,3.8,0.1,99.6,0,48018,30129,29878,29150,29629,105,273,465,1875,38,49736,0,18140,29878,105,168,192,1410,36.3,59.8,0.2,0.3,0.4,2.8
E06000012,NORTH EAST LINCOLNSHIRE,75541,75458,97.1,90.9,90.9,25.1,90.9,0.1,0.9,1.3,2.8,0.2,97.7,22.9,73345,68638,68638,18997,68638,68,668,969,2113,150,73827,17278,4707,68638,68,600,301,1144,6.2,90.9,0.1,0.8,0.4,1.5
E07000099,NORTH HERTFORDSHIRE,62054,62034,97.4,82.3,81.5,44.6,81,0.1,0.2,0.5,2.5,0.1,98.9,0.2,60465,51066,50578,27704,50252,38,143,310,1569,67,61379,125,9887,50578,38,105,167,1259,15.9,81.5,0.1,0.2,0.3,2
E07000139,NORTH KESTEVEN,56413,56307,95,58.9,58.3,34.8,58,0.6,1.2,1.9,4.8,0.3,98.8,33,53614,33221,32892,19636,32699,346,671,1049,2693,146,55729,18592,20722,32892,346,325,378,1644,36.7,58.3,0.6,0.6,0.7,2.9
S12000050,NORTH LANARKSHIRE,167006,166923,98.4,87.8,87.2,30.3,86.9,0.1,0.3,0.6,1.5,0.1,99.2,0,164376,146665,145686,50644,145157,85,457,933,2547,141,165723,0,18690,145686,85,372,476,1614,11.2,87.2,0.1,0.2,0.3,1
E06000013,NORTH LINCOLNSHIRE,81397,81255,95.7,73.3,73.3,65.1,73.3,0.5,1,1.5,4.2,0.3,98.2,59.3,77858,59673,59668,53005,59673,422,849,1205,3397,204,79953,48237,18190,59668,422,427,356,2192,22.3,73.3,0.5,0.5,0.4,2.7
E07000147,NORTH NORFOLK,61431,61304,93.8,15.4,15.4,15.3,15.4,0.4,1,1.7,6,1.1,98.6,0.2,57593,9435,9435,9428,9435,267,603,1071,3711,697,60565,93,48158,9435,267,336,468,2640,78.4,15.4,0.4,0.5,0.8,4.3
E06000061,NORTH NORTHAMPTONSHIRE,166864,166761,98.7,82.1,82,49.5,82,0.1,0.3,0.4,1.2,0.1,99.4,0,164775,137014,136792,82650,136792,218,421,728,1986,111,165853,30,27983,136792,218,203,307,1258,16.8,82,0.1,0.1,0.2,0.8
E06000024,NORTH SOMERSET,104514,104410,95.1,74.5,70.6,57.2,67.7,0.2,0.6,1.1,4.8,0.3,97.6,0,99374,77860,73764,59788,70737,173,577,1098,5036,302,102003,0,25610,73764,173,404,521,3938,24.5,70.6,0.2,0.4,0.5,3.8
E08000022,NORTH TYNESIDE,103460,103365,99.2,88.4,86.6,55,84.9,0,0.2,0.4,0.7,0,99.4,0,102659,91445,89618,56892,87790,50,185,373,706,33,102859,0,13041,89618,50,135,188,333,12.6,86.6,0,0.1,0.2,0.3
E07000218,NORTH WARWICKSHIRE,31235,31150,97.6,46.9,45.1,31.1,43.7,0.2,0.6,0.8,2.2,0,99.3,0,30478,14645,14084,9721,13664,67,177,235,672,10,31023,0,16394,14084,67,110,58,437,52.5,45.1,0.2,0.4,0.2,1.4
E07000134,NORTH WEST LEICESTERSHIRE,50526,50494,98,77.1,76,26.4,74.7,0.1,0.5,0.8,1.9,0.1,99.4,0,49517,38957,38383,13361,37756,73,262,402,977,45,50235,0,11134,38383,73,189,140,575,22,76,0.1,0.4,0.3,1.1
E06000057,NORTHUMBERLAND,163328,163074,94.7,42.1,41.2,39.9,40.5,0.7,1.4,2,5.1,0.6,99,2.3,154689,68799,67268,65237,66124,1181,2214,3311,8385,970,161620,3817,87421,67268,1181,1033,1097,5074,53.5,41.2,0.7,0.6,0.7,3.1
E07000148,NORWICH,57957,57855,99,90.9,89.1,48.3,87,0,0,0.1,0.8,0,99.2,0,57377,52700,51662,27991,50443,1,6,67,478,5,57504,2,5715,51662,1,5,61,411,9.9,89.1,0,0,0.1,0.7
E06000018,NOTTINGHAM,144370,144319,98.5,94,93.4,56.1,93,0,0.1,0.2,1.5,0,98.6,0,142165,135669,134852,81021,134246,16,90,262,2154,0,142298,0,7313,134852,16,74,172,1892,5.1,93.4,0,0.1,0.1,1.3
E07000219,NUNEATON AND BEDWORTH,62430,62376,99.2,86.7,86.7,22.7,86.7,0,0.1,0.2,0.8,0,99.6,0,61901,54144,54142,14162,54142,19,78,133,475,3,62154,0,7759,54142,19,59,55,342,12.4,86.7,0,0.1,0.1,0.5
E07000135,OADBY AND WIGSTON,25832,25801,99.2,81.5,78.8,13.2,77.2,0,0,0,0.7,0,99.7,0,25614,21052,20361,3420,19948,0,4,10,187,0,25749,0,5253,20361,0,4,6,177,20.3,78.8,0,0,0,0.7
E08000004,OLDHAM,99672,99538,98.7,87.8,87.7,51.7,87.7,0.1,0.1,0.2,1.1,0,99.7,0.1,98393,87508,87445,51553,87409,76,148,197,1145,0,99420,147,10948,87445,76,72,49,948,11,87.7,0.1,0.1,0,1
S12000023,ORKNEY ISLANDS,13159,12889,68.5,5.1,5.1,5.1,5.1,2.5,6.1,16.7,29.4,4.4,78.3,0,9019,669,669,669,669,335,808,2201,3870,580,10300,0,8350,669,335,473,1393,1669,63.5,5.1,2.5,3.6,10.6,12.7
E07000178,OXFORD,69194,67199,95.8,82.2,77.3,15.7,73.4,0,0.1,0.4,1.3,0,96.1,0,66279,56871,53503,10872,50782,3,57,248,920,0,66524,0,12776,53503,3,54,191,672,18.5,77.3,0,0.1,0.3,1
W06000009,PEMBROKESHIRE,66658,66575,92.9,31.7,31.7,31.7,31.7,1.1,2.4,3.6,7,0.8,96.9,2.9,61905,21153,21153,21153,21153,733,1586,2400,4670,534,64566,1955,40752,21153,733,853,814,2270,61.1,31.7,1.1,1.3,1.2,3.4
E07000122,PENDLE,44741,44685,96.9,70.1,69.7,48.1,69.3,0.4,0.8,1.1,3,0.1,99.2,51.8,43345,31343,31197,21513,31007,197,369,491,1340,46,44370,23186,12148,31197,197,172,122,849,27.2,69.7,0.4,0.4,0.3,1.9
S12000048,PERTH AND KINROSS,80611,80397,87.3,41.4,40.6,12.3,40,1.3,3.4,6.1,12.5,1.3,95.8,0,70352,33341,32750,9939,32253,1059,2779,4923,10045,1031,77256,1,37602,32750,1059,1720,2144,5122,46.6,40.6,1.3,2.1,2.7,6.4
E06000031,PETERBOROUGH,94646,94529,98.7,89.8,89.6,86.7,89.4,0.1,0.3,0.4,1.1,0,99.5,0,93447,85023,84756,82094,84638,53,246,373,1082,45,94144,0,8691,84756,53,193,127,709,9.2,89.6,0.1,0.2,0.1,0.7
E06000026,PLYMOUTH,127670,126647,97.1,90.8,90.2,35.5,89.6,0,0.1,0.8,2.1,0,97.4,26.6,123913,115976,115129,45315,114393,1,137,1051,2734,1,124396,33910,8784,115129,1,136,914,1683,6.9,90.2,0,0.1,0.7,1.3
E06000044,PORTSMOUTH,96254,96172,98.1,96.3,95,58.4,94.2,0,0.1,0.4,1.9,0,98.1,0,94378,92696,91453,56249,90665,1,134,418,1794,1,94421,0,2925,91453,1,133,284,1376,3,95,0,0.1,0.3,1.4
W06000023,POWYS,70706,69669,84,32.1,32,32.1,32.1,2.7,5.7,8.5,14.5,3.5,91.9,6.1,59418,22683,22603,22680,22683,1942,4043,6031,10251,2440,64960,4339,36815,22603,1942,2101,1988,4220,52.1,32,2.7,3,2.8,6
E07000123,PRESTON,70400,70325,98,75.6,74.4,25.8,73.9,0,0.1,0.2,1.9,0,99.1,59.1,69022,53218,52383,18138,52043,14,47,162,1303,3,69776,41595,16639,52383,14,33,115,1141,23.6,74.4,0,0,0.2,1.6
E06000038,READING,77627,77574,98.7,94.1,92.6,77.2,91,0,0.1,0.2,1.2,0,98.8,0,76612,73083,71873,59892,70603,9,69,125,962,0,76662,0,4739,71873,9,60,56,837,6.1,92.6,0,0.1,0.1,1.1
E09000026,REDBRIDGE,112142,112080,98.6,90.1,89.4,64,88.8,0,0.1,0.3,1.3,0,98.8,0,110573,101060,100261,71791,99637,12,136,381,1507,1,110782,0,10312,100261,12,124,245,1126,9.2,89.4,0,0.1,0.2,1
E06000003,REDCAR AND CLEVELAND,69258,69232,97.9,88.6,87.9,7.8,87.5,0.1,0.5,0.9,2.1,0.1,98.9,0.6,67794,61364,60879,5408,60626,93,331,626,1438,85,68515,448,6915,60879,93,238,295,812,10,87.9,0.1,0.3,0.4,1.2
E07000236,REDDITCH,40331,40178,98.6,84.2,84.2,18.6,84.2,0,0,0.1,1,0,99.3,0,39776,33956,33954,7511,33956,3,12,46,402,4,40037,0,5822,33954,3,9,34,356,14.4,84.2,0,0,0.1,0.9
E07000211,REIGATE AND BANSTEAD,65676,65652,98.2,83.3,82.9,50.7,82.7,0,0.1,0.1,1.8,0,99.8,0,64481,54731,54440,33278,54289,10,42,65,1171,17,65555,0,10041,54440,10,32,23,1106,15.3,82.9,0,0,0,1.7
S12000038,RENFREWSHIRE,97141,97078,98,91.7,91.7,80.4,91.7,0.1,0.3,0.7,2,0,98.9,0,95154,89093,89093,78089,89093,119,300,651,1924,35,96057,0,6061,89093,119,181,351,1273,6.2,91.7,0.1,0.2,0.4,1.3
W06000016,RHONDDA CYNON TAF,119929,119736,98.2,44.7,43.2,35,42.2,0,0.1,0.3,1.7,0,99.3,26.5,117735,53615,51830,41997,50573,51,90,340,2001,30,119088,31786,65905,51830,51,39,250,1661,55,43.2,0,0,0.2,1.4
E07000124,RIBBLE VALLEY,31348,31295,93.2,64.9,64.7,64.2,64.7,0.6,1.7,2.9,6.6,0.2,98.9,65.7,29226,20333,20283,20113,20267,185,521,899,2069,71,30991,20590,8943,20283,185,336,378,1170,28.5,64.7,0.6,1.1,1.2,3.7
E09000027,RICHMOND UPON THAMES,89141,88983,98.4,89.8,88.6,44.3,87.3,0,0,0.2,1.5,0,98.5,0,87688,80078,78970,39471,77800,1,25,139,1295,1,87782,0,8718,78970,1,24,114,1156,9.8,88.6,0,0,0.1,1.3
E07000166,RICHMONDSHIRE,25363,25311,88.5,41.6,34.1,28.8,28.8,1.7,3.6,5.7,11.3,1.7,96.8,51.3,22446,10542,8645,7293,7293,437,902,1454,2865,423,24556,13003,13801,8645,437,465,552,1411,54.4,34.1,1.7,1.8,2.2,5.6
E08000005,ROCHDALE,102626,102550,98.3,76.7,71.7,26.6,67.9,0,0.1,0.3,1.6,0,99.6,0,100915,78756,73553,27327,69691,34,134,352,1635,7,102246,4,27362,73553,34,100,218,1283,26.7,71.7,0,0.1,0.2,1.3
E07000075,ROCHFORD,38905,38855,98.9,54.3,51.9,49.9,49.9,0,0.1,0.2,1,0,99.6,0,38461,21135,20196,19416,19418,2,47,96,394,10,38757,0,18265,20196,2,45,49,298,46.9,51.9,0,0.1,0.1,0.8
E07000125,ROSSENDALE,35018,34978,95,55.2,46.1,4.6,37.9,0.1,0.6,0.8,4.9,0,99,0,33267,19332,16128,1601,13286,42,221,280,1711,4,34660,9,17139,16128,42,179,59,1431,48.9,46.1,0.1,0.5,0.2,4.1
E07000064,ROTHER,50290,50082,96.1,51.8,51.8,51.8,51.8,0.1,0.2,0.6,3.4,0.2,99.3,0.7,48350,26042,26042,26042,26042,42,105,318,1732,85,49956,340,22308,26042,42,63,213,1414,44.4,51.8,0.1,0.1,0.4,2.8
E08000018,ROTHERHAM,126613,126531,98.7,76.2,74.8,48.1,74.2,0,0.3,0.5,1.3,0,99.3,4.8,124919,96509,94745,60892,93911,40,323,597,1612,52,125752,6043,30174,94745,40,283,274,1015,23.8,74.8,0,0.2,0.2,0.8
E07000220,RUGBY,51965,51926,98.3,77.1,74.7,50.3,72.7,0.2,0.4,0.5,1.6,0,99.5,0,51091,40042,38834,26162,37759,105,187,274,835,12,51682,1,12257,38834,105,82,87,561,23.6,74.7,0.2,0.2,0.2,1.1
E07000212,RUNNYMEDE,39497,39247,97.3,81.3,79.8,43.9,77.9,0,0.1,0.7,2.1,0,98.2,0,38418,32093,31520,17342,30779,3,22,276,829,7,38785,0,6898,31520,3,19,254,553,17.5,79.8,0,0,0.6,1.4
E07000176,RUSHCLIFFE,56417,56363,98,79.9,77.3,47.3,75.3,0.2,0.4,0.7,1.9,0.1,99.5,3.7,55270,45057,43587,26698,42493,95,219,423,1093,65,56162,2079,11683,43587,95,124,204,670,20.7,77.3,0.2,0.2,0.4,1.2
E07000092,RUSHMOOR,43771,43732,97.7,87.3,87.3,46.9,87.3,0.1,0.7,1.8,2.2,0.1,98,0,42784,38191,38191,20510,38191,27,306,769,948,32,42882,0,4593,38191,27,279,463,179,10.5,87.3,0.1,0.6,1.1,0.4
E06000017,RUTLAND,18930,18898,92.7,53.6,53.6,53.6,53.6,0.3,0.5,0.8,7.2,0.1,99.4,0.2,17544,10141,10141,10141,10141,48,91,151,1354,28,18818,37,7403,10141,48,43,60,1203,39.1,53.6,0.3,0.2,0.3,6.4
E07000167,RYEDALE,30882,30642,88.2,34,34,34,34,2.1,3.9,5.6,11,1.5,96.1,50.4,27253,10496,10496,10496,10496,658,1210,1742,3389,467,29674,15576,16757,10496,658,552,532,1647,54.3,34,2.1,1.8,1.7,5.3
E08000006,SALFORD,134158,134056,96.3,85.6,85.3,68.3,85,0,0.8,1.6,3.7,0,96.5,0,129138,114905,114436,91606,114049,29,1117,2125,4918,2,129504,0,14702,114436,29,1088,1008,2793,11,85.3,0,0.8,0.8,2.1
E08000028,SANDWELL,143922,143548,99.2,89.3,88.7,44,88.2,0,0.1,0.2,0.6,0,99.2,0,142707,128525,127723,63353,126888,21,76,330,841,9,142753,0,14984,127723,21,55,254,511,10.4,88.7,0,0,0.2,0.4
E07000168,SCARBOROUGH,64629,64510,95.1,8.4,8.4,8.4,8.4,0.5,1.1,1.6,4.7,0.4,98.3,40.7,61494,5421,5421,5417,5421,333,715,1035,3016,244,63501,26330,56073,5421,333,382,320,1981,86.8,8.4,0.5,0.6,0.5,3.1
S12000026,SCOTTISH BORDERS,65557,65334,89.2,33.8,31.7,30.1,30.1,1.2,2.9,5.2,10.5,1.9,95.8,15.5,58476,22147,20786,19734,19734,798,1901,3440,6858,1231,62809,10146,37690,20786,798,1103,1539,3418,57.5,31.7,1.2,1.7,2.3,5.2
E07000188,SEDGEMOOR,60797,60734,95,70,67.2,65.1,65.1,0.3,0.7,1.5,4.9,0.3,98.1,0,57772,42534,40831,39558,39558,155,419,882,2962,160,59651,0,16941,40831,155,264,463,2080,27.9,67.2,0.3,0.4,0.8,3.4
E08000014,SEFTON,138611,137730,98.6,77,71.7,47.8,67.1,0,0.1,0.1,0.8,0,99.1,0,136620,106793,99345,66245,93009,5,141,186,1110,18,137344,0,37275,99345,5,136,45,924,26.9,71.7,0,0.1,0,0.7
E07000169,SELBY,44280,44228,95.6,63.2,63.2,63.2,63.2,0.6,1.1,1.6,4.2,0.2,99.2,29.6,42351,27997,27997,27996,27997,287,477,718,1877,107,43915,13116,14354,27997,287,190,241,1159,32.4,63.2,0.6,0.4,0.5,2.6
E07000111,SEVENOAKS,53905,53867,95.4,67.9,67.7,46.2,65.9,0.2,0.4,0.7,4.5,0.1,99.6,0,51441,36592,36510,24889,35527,92,206,381,2426,69,53665,0,14931,36510,92,114,175,2045,27.7,67.7,0.2,0.2,0.3,3.8
E08000019,SHEFFIELD,264804,264563,97.2,79.6,78,64,77,0,0.1,0.6,2.7,0,97.7,0.1,257461,210714,206574,169435,203877,53,226,1591,7102,42,258608,202,50887,206574,53,173,1365,5511,19.2,78,0,0.1,0.5,2.1
S12000027,SHETLAND ISLANDS,13211,13088,73.7,6.4,6.4,6.4,6.4,3,7.3,16,25.4,4.5,85,0,9734,850,850,850,850,390,958,2113,3354,590,11231,0,8884,850,390,568,1155,1241,67.2,6.4,3,4.3,8.7,9.4
E06000051,SHROPSHIRE,156668,156304,90.1,54.4,43.9,45.8,48.6,0.8,2.3,4.2,9.7,0.3,96.5,75,141098,85194,68850,71825,76089,1276,3545,6507,15206,520,151161,117508,72248,68850,1276,2269,2962,8699,46.1,43.9,0.8,1.4,1.9,5.6
E06000039,SLOUGH,58582,58472,98.7,95.2,93.6,77.6,92.4,0,0.1,0.1,1.1,0,98.8,0,57838,55748,54849,45484,54141,13,69,86,634,2,57896,0,2989,54849,13,56,17,548,5.1,93.6,0,0.1,0,0.9
E08000029,SOLIHULL,99537,99487,98.3,92,91.7,59.6,91.5,0.2,0.3,0.8,1.7,0,98.7,0,97808,91578,91261,59358,91077,245,335,781,1679,7,98197,1,6547,91261,245,90,446,898,6.6,91.7,0.2,0.1,0.4,0.9
E07000246,SOMERSET WEST AND TAUNTON,79843,79660,91.7,55.2,52.4,51.2,51.2,0.7,2,3.3,8.1,0.5,97.2,5.3,73203,44055,41799,40867,40870,575,1580,2667,6457,422,77593,4247,31404,41799,575,1005,1087,3790,39.3,52.4,0.7,1.3,1.4,4.7
S12000028,SOUTH AYRSHIRE,60108,60065,97.9,71,70.3,55.5,69.9,0.1,0.3,0.6,2.1,0.1,99.6,0,58831,42652,42266,33341,42022,57,177,364,1234,88,59848,0,16565,42266,57,120,187,870,27.6,70.3,0.1,0.2,0.3,1.4
E07000012,SOUTH CAMBRIDGESHIRE,74432,74359,97.3,74.9,74,42.3,72.1,0.2,0.4,1,2.6,0.1,98.8,0.2,72413,55723,55095,31511,53699,159,317,757,1946,65,73522,149,17318,55095,159,158,440,1189,23.3,74,0.2,0.2,0.6,1.6
E07000039,SOUTH DERBYSHIRE,51478,51007,96.2,72.2,71.1,69.4,70,0.2,0.6,0.9,2.8,0.2,98.5,0,49540,37165,36578,35705,36057,128,320,479,1467,82,50692,0,12962,36578,128,192,159,988,25.2,71.1,0.2,0.4,0.3,1.9
E06000025,SOUTH GLOUCESTERSHIRE,130565,130398,98.6,82.8,82.6,31,82.4,0.1,0.2,0.4,1.3,0.1,99.4,0,128751,108126,107783,40540,107545,87,238,587,1647,89,129825,0,20968,107783,87,151,349,1060,16.1,82.6,0.1,0.1,0.3,0.8
E07000044,SOUTH HAMS,49914,49352,85,44.7,44.1,43.9,44.4,0.7,2,4.8,13.9,1.2,94.9,27.2,42418,22327,22022,21913,22151,325,1011,2408,6934,576,47357,13598,20396,22022,325,686,1397,4526,40.9,44.1,0.7,1.4,2.8,9.1
E07000140,SOUTH HOLLAND,45736,45641,91.9,55.9,55.5,55.1,55.2,0.4,1.4,2.4,7.9,0.7,99,0,42050,25569,25389,25223,25224,172,624,1092,3591,343,45289,15,16661,25389,172,452,468,2499,36.4,55.5,0.4,1,1,5.5
E07000141,SOUTH KESTEVEN,70108,69995,95.1,69.7,68.7,51.4,67.8,1,1.4,1.9,4.7,0.2,99.1,2,66668,48873,48171,36055,47537,681,1010,1355,3327,152,69505,1397,18497,48171,681,329,345,1972,26.4,68.7,1,0.5,0.5,2.8
E07000031,SOUTH LAKELAND,61178,61091,95.3,42.1,42.1,42,42,0.3,0.8,1.5,4.5,0.6,98.8,33.7,58310,25779,25739,25704,25704,197,503,889,2781,340,60447,20617,32571,25739,197,306,386,1892,53.2,42.1,0.3,0.5,0.6,3.1
S12000029,SOUTH LANARKSHIRE,164746,164665,97.1,78.9,78.8,35.2,78.7,0.3,0.7,1.3,2.9,0.2,99.1,0,159914,129949,129798,57922,129643,512,1146,2093,4751,277,163220,0,30116,129798,512,634,947,2658,18.3,78.8,0.3,0.4,0.6,1.6
E07000149,SOUTH NORFOLK,67998,67941,95,45.9,45.2,40.9,44.8,0.3,0.8,1.5,4.9,0.5,99.1,0,64609,31210,30747,27826,30495,216,566,991,3332,361,67356,33,33862,30747,216,350,425,2341,49.8,45.2,0.3,0.5,0.6,3.4
E07000179,SOUTH OXFORDSHIRE,68885,68815,98.1,74.3,67.2,50.9,69.6,0.1,0.2,0.3,1.8,0.1,99.7,0,67547,51159,46307,35033,47977,65,151,227,1268,48,68684,0,21240,46307,65,86,76,1041,30.8,67.2,0.1,0.1,0.1,1.5
E07000126,SOUTH RIBBLE,54234,54186,97.6,76.7,76.3,49.9,75.7,0,0.3,0.5,2.3,0,99.4,38.1,52942,41601,41394,27059,41056,13,188,281,1244,2,53921,20637,11548,41394,13,175,93,963,21.3,76.3,0,0.3,0.2,1.8
E07000189,SOUTH SOMERSET,85603,85473,93.9,52.6,52.2,52.1,52.1,0.3,1,1.8,6,0.2,98.3,1.7,80357,44998,44721,44616,44616,225,885,1566,5116,213,84174,1453,35636,44721,225,660,681,3550,41.6,52.2,0.3,0.8,0.8,4.1
E07000196,SOUTH STAFFORDSHIRE,51030,50963,93.9,51.2,48.9,47,47.3,0.2,0.8,1.4,6,0,99,5,47919,26114,24957,24006,24142,84,410,730,3044,16,50540,2557,22962,24957,84,326,320,2314,45,48.9,0.2,0.6,0.6,4.5
E08000023,SOUTH TYNESIDE,76179,76170,98.2,84.1,83.8,12,83.7,0.1,0.3,0.6,1.8,0,98.9,0,74799,64046,63862,9134,63780,65,266,465,1371,3,75307,0,10937,63862,65,201,199,906,14.4,83.8,0.1,0.3,0.3,1.2
E06000045,SOUTHAMPTON,114546,114337,98.1,96,95.4,84.4,95,0,0,0.2,1.7,0,98.3,0,112384,109954,109287,96675,108851,1,20,217,1953,8,112563,0,3097,109287,1,19,197,1736,2.7,95.4,0,0,0.2,1.5
E06000033,SOUTHEND-ON-SEA,87521,87404,99,95.5,94.6,88.2,93.6,0,0,0,0.9,0,99.1,0.2,86648,83552,82803,77189,81957,0,1,16,756,0,86715,162,3845,82803,0,1,15,740,4.4,94.6,0,0,0,0.8
E09000028,SOUTHWARK,152381,151825,95.2,83.5,83.3,64.1,82.7,0,0,0.2,4.4,0,95.2,0,145096,127231,126976,97668,126022,0,4,235,6729,0,145106,21,18120,126976,0,4,231,6494,11.9,83.3,0,0,0.2,4.3
E07000213,SPELTHORNE,45688,45631,97.8,90.3,89.5,70.1,88.6,0,0,0.6,2.1,0,98.3,0,44676,41239,40904,32008,40457,1,21,258,955,2,44934,0,3772,40904,1,20,237,697,8.3,89.5,0,0,0.5,1.5
E07000240,ST ALBANS,65579,65474,98.3,91.1,89.8,59.6,88.2,0,0.1,0.3,1.6,0,99,0,64448,59770,58880,39067,57846,29,60,170,1026,30,64935,0,5568,58880,29,31,110,856,8.5,89.8,0,0,0.2,1.3
E08000013,ST. HELENS,89261,89180,97.7,87.8,87.5,22.2,87.4,0.1,0.5,0.8,2.2,0,99.1,2.7,87225,78360,78129,19782,78028,100,447,722,1955,7,88441,2429,9096,78129,100,347,275,1233,10.2,87.5,0.1,0.4,0.3,1.4
E07000197,STAFFORD,66582,66087,94.4,68.5,68.5,29.4,68.5,0.3,0.8,1.5,4.8,0.2,98.2,0.6,62872,45621,45618,19565,45621,180,502,1008,3215,110,65391,385,17254,45618,180,322,506,2207,25.9,68.5,0.3,0.5,0.8,3.3
E07000198,STAFFORDSHIRE MOORLANDS,47131,47080,92.6,56.3,55.4,31.4,55,0.6,1.5,2.8,7.3,0.8,98.5,0,43641,26548,26093,14809,25935,283,726,1301,3439,365,46444,1,17548,26093,283,443,575,2138,37.2,55.4,0.6,0.9,1.2,4.5
E07000243,STEVENAGE,39845,39827,99.4,90.3,90.3,20.8,90.3,0,0,0.1,0.6,0,99.5,0,39604,35989,35989,8296,35989,0,17,32,223,0,39626,0,3615,35989,0,17,15,191,9.1,90.3,0,0,0,0.5
S12000030,STIRLING,47072,46900,90.3,53.1,50.7,49.6,49.7,1.3,2.7,4.2,9.4,1.7,97,0,42485,24997,23860,23363,23374,622,1258,1980,4415,787,45637,0,18625,23860,622,636,722,2435,39.6,50.7,1.3,1.4,1.5,5.2
E08000007,STOCKPORT,141170,141093,98.8,90.1,90.1,50.6,90,0,0.1,0.1,1.1,0,99.4,0,139495,127206,127126,71398,127072,29,111,180,1598,0,140320,0,12369,127126,29,82,69,1418,8.8,90.1,0,0.1,0,1
E06000004,STOCKTON-ON-TEES,93507,93417,96.5,92.4,92.1,45.2,92.1,0.1,0.6,1.6,3.4,0.1,97.1,19,90263,86354,86165,42284,86113,96,597,1474,3154,137,90755,17805,4098,86165,96,501,877,1680,4.4,92.1,0.1,0.5,0.9,1.8
E06000021,STOKE-ON-TRENT,124659,124478,98.6,91.4,91.4,50.7,91.4,0,0.1,0.2,1.3,0,98.9,0,122884,113926,113925,63148,113923,0,79,249,1594,0,123237,0,8959,113925,0,79,170,1345,7.2,91.4,0,0.1,0.1,1.1
E07000221,STRATFORD-ON-AVON,69278,69157,96.6,67.3,64.2,49.1,61.6,0.3,0.7,1.1,3.3,0.2,98.7,1,66895,46634,44453,34013,42691,178,458,732,2262,150,68366,705,22442,44453,178,280,274,1530,32.4,64.2,0.3,0.4,0.4,2.2
E07000082,STROUD,58879,58801,94.6,38.8,38.8,37.9,38.8,0.1,0.4,1.1,5.3,0.1,96.6,1.1,55676,22866,22866,22306,22866,69,231,629,3125,38,56849,645,32810,22866,69,162,398,2496,55.7,38.8,0.1,0.3,0.7,4.2
E08000024,SUNDERLAND,139344,139165,97.8,85.7,84.4,38.2,83.8,0.1,0.3,0.7,2.1,0,98.2,0,136232,119358,117607,53228,116752,115,351,1025,2933,63,136820,0,18625,117607,115,236,674,1908,13.4,84.4,0.1,0.2,0.5,1.4
E07000214,SURREY HEATH,39695,39673,98.7,82.8,82.4,52,82.2,0,0,0.2,1.3,0,99.8,0,39161,32856,32697,20649,32644,0,8,71,512,0,39607,0,6464,32697,0,8,63,441,16.3,82.4,0,0,0.2,1.1
E09000029,SUTTON,88149,88114,98.7,90,89.3,60.8,88.6,0,0,0,1.3,0,98.9,0,86976,79305,78716,53563,78105,11,21,44,1138,0,87138,0,8260,78716,11,10,23,1094,9.4,89.3,0,0,0,1.2
E07000113,SWALE,69046,68836,95.2,74.9,73.2,59.1,71.7,0.2,0.6,1.2,4.5,0.1,98.9,29.3,65734,51722,50566,40790,49486,155,431,861,3102,78,68253,20236,15168,50566,155,276,430,2241,22,73.2,0.2,0.4,0.6,3.2
W06000011,SWANSEA,119131,119028,98.3,84.7,82.8,45.1,81.5,0.1,0.2,0.5,1.6,0.1,99.1,48.9,117123,100888,98593,53787,97102,119,244,573,1905,105,118026,58288,18530,98593,119,125,329,1332,15.6,82.8,0.1,0.1,0.3,1.1
E06000030,SWINDON,103977,103941,96.7,92.5,91.6,84.5,90.9,0.1,0.4,0.8,3.2,0.1,97.2,0,100597,96207,95287,87899,94508,88,408,857,3344,153,101042,14,5310,95287,88,320,449,2487,5.1,91.6,0.1,0.3,0.4,2.4
E08000008,TAMESIDE,116828,116597,98,73.2,72.6,49.4,72.1,0,0,0.1,1.9,0,99.5,0,114434,85567,84819,57708,84199,0,8,118,2163,3,116270,0,29615,84819,0,8,110,2045,25.3,72.6,0,0,0.1,1.8
E07000199,TAMWORTH,36405,36389,99.3,86.8,83.8,9.9,80,0.1,0.1,0.2,0.6,0,99.7,0,36158,31588,30525,3588,29141,30,35,85,231,1,36283,0,5633,30525,30,5,50,146,15.5,83.8,0.1,0,0.1,0.4
E07000215,TANDRIDGE,39284,39243,95.3,63.9,62.8,24.9,62.3,0.1,0.5,0.8,4.6,0.1,99.5,0,37435,25084,24676,9791,24458,34,185,331,1808,54,39086,0,12759,24676,34,151,146,1477,32.5,62.8,0.1,0.4,0.4,3.8
E07000045,TEIGNBRIDGE,67716,67646,90.9,58.5,57.2,41.9,58.5,0.5,1.5,3,9,0.5,97.3,28.3,61545,39621,38758,28365,39621,308,1047,2019,6101,352,65908,19197,22787,38758,308,739,972,4082,33.7,57.2,0.5,1.1,1.4,6
E06000020,TELFORD AND WREKIN,85353,85190,98,83.4,81.3,16.1,79.8,0.1,0.2,0.4,1.8,0,99.1,36.5,83676,71187,69427,13761,68143,52,152,305,1514,22,84584,31124,14249,69427,52,100,153,1209,16.7,81.3,0.1,0.1,0.2,1.4
E07000076,TENDRING,76315,76108,98.5,44,44,44,44,0.1,0.1,0.4,1.3,0.1,99.3,1.3,75136,33559,33559,33552,33559,48,92,308,972,52,75767,992,41577,33559,48,44,216,664,54.5,44,0.1,0.1,0.3,0.9
E07000093,TEST VALLEY,61375,61279,94.4,69.9,69.5,24.7,69.2,0.2,1.2,2,5.5,0.4,98.4,0,57924,42921,42660,15129,42455,147,709,1229,3355,269,60418,0,15264,42660,147,562,520,2126,24.9,69.5,0.2,0.9,0.8,3.5
E07000083,TEWKESBURY,47472,47384,93.8,73.9,72.4,45.5,73.2,0.1,0.7,1.9,6.1,0.2,94.9,0.5,44511,35069,34368,21620,34768,55,331,883,2873,97,45065,226,10143,34368,55,276,552,1990,21.4,72.4,0.1,0.6,1.2,4.2
E07000114,THANET,74428,74220,97.6,65.1,65.1,65,65.1,0,0.6,1,2.1,0.1,99.3,24.5,72666,48445,48445,48350,48445,13,456,708,1554,38,73942,18229,24221,48445,13,443,252,846,32.5,65.1,0,0.6,0.3,1.1
E07000102,THREE RIVERS,40195,39965,97.7,88.6,87.3,71.7,85.7,0.2,0.2,0.3,1.7,0,99.2,0,39283,35613,35077,28810,34430,68,89,132,682,7,39884,0,4206,35077,68,21,43,550,10.5,87.3,0.2,0.1,0.1,1.4
E06000034,THURROCK,73027,72913,97.2,86.5,85.5,62.3,84.9,0.1,0.4,1.2,2.6,0.1,98,0,70978,63165,62466,45484,62003,96,258,858,1935,42,71540,6,8512,62466,96,162,600,1077,11.7,85.5,0.1,0.2,0.8,1.5
E07000115,TONBRIDGE AND MALLING,58284,58228,96.4,77,75.2,46.5,73.6,0.1,0.4,0.9,3.5,0.2,98.8,8.5,56212,44872,43810,27077,42897,52,237,551,2016,92,57607,4935,12402,43810,52,185,314,1465,21.3,75.2,0.1,0.3,0.5,2.5
E06000027,TORBAY,78650,78209,96.5,85.7,84.3,75.6,82.8,0,0.1,0.2,2.9,0,98,0.2,75928,67412,66280,59444,65136,3,68,137,2281,14,77045,129,9648,66280,3,65,69,2144,12.3,84.3,0,0.1,0.1,2.7
W06000020,TORFAEN,46545,46418,96.7,54.3,46.6,18.9,41.6,0.1,0.6,1.2,3,0,97.6,64.3,45013,25290,21712,8819,19384,56,277,549,1405,6,45436,29931,23301,21712,56,221,272,856,50.1,46.6,0.1,0.5,0.6,1.8
E07000046,TORRIDGE,34947,34827,83.9,42.8,38.9,42.8,42.8,2.3,5.5,9.1,15.8,1.1,94,45.5,29316,14958,13591,14957,14958,808,1933,3177,5511,389,32857,15889,15725,13591,808,1125,1244,2334,45,38.9,2.3,3.2,3.6,6.7
E09000030,TOWER HAMLETS,153978,152565,94.6,81.2,79.2,66.8,77.6,0,0.1,0.5,4.5,0,94.6,0,145655,125035,121964,102843,119505,0,105,768,6910,0,145677,0,23691,121964,0,105,663,6142,15.4,79.2,0,0.1,0.4,4
E08000009,TRAFFORD,109571,109476,98.5,81.4,79.3,39.2,77.5,0,0.2,0.3,1.4,0,99.2,0.2,107916,89205,86851,42991,84888,52,187,334,1560,20,108706,260,21065,86851,52,135,147,1226,19.2,79.3,0,0.1,0.1,1.1
E07000116,TUNBRIDGE WELLS,54324,54260,96,76,74.3,62.1,71.7,0.1,0.4,1,3.9,0.3,99.2,0.1,52130,41313,40377,33733,38936,45,241,527,2130,140,53871,78,11753,40377,45,196,286,1603,21.6,74.3,0.1,0.4,0.5,3
E07000077,UTTLESFORD,41673,41605,95.6,64.6,62.7,46.4,61.1,0.2,0.5,1.5,4.3,0.5,97.5,1.5,39828,26900,26109,19322,25472,80,212,612,1777,191,40621,626,13719,26109,80,132,400,1165,32.9,62.7,0.2,0.3,1,2.8
W06000014,VALE OF GLAMORGAN,64324,64194,97.8,83.2,82.3,73.8,81.2,0.2,0.9,1.1,2,0.2,98.8,10.1,62927,53547,52952,47459,52240,130,567,714,1267,131,63525,6521,9975,52952,130,437,147,553,15.5,82.3,0.2,0.7,0.2,0.9
E07000180,VALE OF WHITE HORSE,65088,64981,97.8,75.5,71.2,35.7,72.4,0.1,0.3,0.5,2,0.1,99.1,0,63666,49112,46368,23234,47111,59,165,309,1315,39,64483,0,17298,46368,59,106,144,1006,26.6,71.2,0.1,0.2,0.2,1.5
E08000036,WAKEFIELD,165872,165673,97.8,80.3,80,70,79.8,0,0.2,0.4,2.1,0,98.9,34.1,162147,133148,132735,116193,132366,82,389,714,3526,34,164076,56535,29412,132735,82,307,325,2812,17.7,80,0,0.2,0.2,1.7
E08000030,WALSALL,118705,118632,98.9,86.4,85.1,40.7,84.4,0,0,0.3,1.1,0,99.2,0,117376,102533,101046,48267,100152,0,26,303,1256,22,117814,0,16330,101046,0,26,277,953,13.8,85.1,0,0,0.2,0.8
E09000031,WALTHAM FOREST,113879,113489,96.8,90.6,89.9,65.6,89.6,0,0.1,1.2,2.9,0,96.9,0,110243,103162,102419,74744,102040,55,105,1311,3246,48,110305,0,7824,102419,55,50,1206,1935,6.9,89.9,0,0,1.1,1.7
E09000032,WANDSWORTH,161851,160897,97.6,91.5,86.8,65.9,82.2,0,0,0.1,1.8,0,97.6,0,158007,148034,140468,106723,133069,0,12,180,2890,0,158022,1,17539,140468,0,12,168,2710,10.8,86.8,0,0,0.1,1.7
E06000007,WARRINGTON,100477,100404,98.6,88.2,86.9,27.8,86,0,0.1,0.2,1.3,0,99.3,0.1,99048,88625,87265,27892,86406,33,101,177,1356,17,99744,140,11783,87265,33,68,76,1179,11.7,86.9,0,0.1,0.1,1.2
E07000222,WARWICK,71410,71304,98.7,84.1,80.1,24,76.1,0,0.2,0.3,1.1,0,99.4,0,70492,60073,57177,17119,54357,34,132,220,812,11,70998,0,13315,57177,34,98,88,592,18.6,80.1,0,0.1,0.1,0.8
E07000103,WATFORD,43545,43458,99.5,94.6,92.3,66.8,90.6,0,0,0,0.3,0,99.5,0,43326,41180,40205,29069,39437,0,2,13,132,0,43331,0,3121,40205,0,2,11,119,7.2,92.3,0,0,0,0.3
E07000216,WAVERLEY,58394,58344,96,61.2,59.7,51.2,58.9,0.2,0.4,0.7,3.9,0.2,99.7,0,56041,35712,34856,29925,34366,100,249,402,2303,115,58197,0,21185,34856,100,149,153,1901,36.3,59.7,0.2,0.3,0.3,3.3
E07000065,WEALDEN,75858,75793,96.8,52.5,52.3,52.3,52.3,0.1,0.3,0.7,3.1,0.2,99.5,0,73462,39842,39707,39672,39674,66,249,528,2331,165,75511,0,33755,39707,66,183,279,1803,44.5,52.3,0.1,0.2,0.4,2.4
E07000241,WELWYN HATFIELD,51141,51133,97.6,79.5,78.3,24.1,77.1,0,0.1,0.3,2.4,0,99.3,0,49890,40669,40058,12338,39452,6,46,162,1243,4,50778,0,9832,40058,6,40,116,1081,19.2,78.3,0,0.1,0.2,2.1
E06000037,WEST BERKSHIRE,73425,73374,98.2,81.5,79,62.5,76.9,0,0.4,0.6,1.8,0.1,98.8,0,72068,59856,58002,45872,56497,36,292,462,1306,47,72551,0,14066,58002,36,256,170,844,19.2,79,0,0.3,0.2,1.1
E07000047,WEST DEVON,27858,27775,81.9,40.3,39.5,40.3,40.3,1.2,4.9,9.9,17.8,1.2,96.1,65.3,22824,11230,10990,11230,11230,337,1362,2748,4951,326,26781,18186,11834,10990,337,1025,1386,2203,42.5,39.5,1.2,3.7,5,7.9
S12000039,WEST DUNBARTONSHIRE,47739,47726,98.9,92,90.9,7.6,89.8,0,0.1,0.3,1,0,99.4,0,47228,43905,43401,3646,42887,10,55,129,498,6,47473,0,3827,43401,10,45,74,369,8,90.9,0,0.1,0.2,0.8
E07000127,WEST LANCASHIRE,53488,53413,96.4,60.5,52.9,47.9,48,0.2,0.7,1.1,3.5,0,99.2,11.6,51549,32373,28318,25597,25670,128,372,592,1864,22,53053,6197,23231,28318,128,244,220,1272,43.4,52.9,0.2,0.5,0.4,2.4
E07000142,WEST LINDSEY,47696,47517,87.7,42.9,41.7,31.5,41.1,1.7,3.9,5.6,11.9,1,97.8,43,41845,20464,19906,15006,19607,827,1877,2660,5672,458,46628,20528,21939,19906,827,1050,783,3012,46,41.7,1.7,2.2,1.6,6.3
S12000040,WEST LOTHIAN,88695,88583,97.9,86.4,85.6,55,84.9,0.1,0.3,0.8,2,0.1,99.1,0,86823,76631,75885,48749,75259,121,297,667,1760,124,87886,0,10938,75885,121,176,370,1093,12.3,85.6,0.1,0.2,0.4,1.2
E06000062,WEST NORTHAMPTONSHIRE,190662,189622,97.9,90.2,88.9,85.3,88.1,0.1,0.4,0.7,1.5,0.1,98.6,0,186702,171883,169559,162553,168031,158,813,1318,2920,201,187997,58,17143,169559,158,655,505,1602,9,88.9,0.1,0.3,0.3,0.8
E07000181,WEST OXFORDSHIRE,55083,55028,99.4,90.3,88.5,72.4,86.9,0,0.1,0.1,0.5,0,99.7,0,54750,49755,48727,39907,47853,14,30,71,278,20,54895,11,6023,48727,14,16,41,207,10.9,88.5,0,0,0.1,0.4
E07000245,WEST SUFFOLK,86774,86723,97.9,63.6,61.8,54.1,60.8,0.1,0.3,0.5,2,0.2,99.6,0,84947,55197,53594,46925,52728,125,267,408,1776,137,86420,21,31353,53594,125,142,141,1368,36.1,61.8,0.1,0.2,0.2,1.6
E09000033,WESTMINSTER,164910,164257,90.9,75.5,75.1,72.2,74.5,0,0,0.1,8.7,0,90.9,0,149844,124503,123898,119119,122848,0,1,225,14413,2,149871,0,25946,123898,0,1,224,14188,15.7,75.1,0,0,0.1,8.6
E08000010,WIGAN,157450,157392,98.7,89.8,89.3,28.1,89,0,0.1,0.2,1.2,0,99.6,13,155433,141419,140677,44187,140104,29,106,293,1959,15,156837,20433,14756,140677,29,77,187,1666,9.4,89.3,0,0,0.1,1.1
E06000054,WILTSHIRE,238620,238436,96.2,61.2,60.8,43,60.5,0.2,0.5,1,3.7,0.2,99.2,1.1,229537,146052,145036,102600,144441,410,1262,2366,8899,496,236633,2569,84501,145036,410,852,1104,6533,35.4,60.8,0.2,0.4,0.5,2.7
E07000094,WINCHESTER,59032,58909,92.6,57.2,56.1,22.4,55.3,0.5,1.2,2,7.1,0.5,97.7,0,54689,33741,33095,13231,32631,280,682,1195,4220,283,57666,0,21594,33095,280,402,513,3025,36.6,56.1,0.5,0.7,0.9,5.1
E06000040,WINDSOR AND MAIDENHEAD,68450,68366,97.9,81.3,78.1,40.4,75.8,0,0.1,0.4,2,0.1,98.7,0,67026,55626,53466,27652,51854,17,92,290,1340,46,67555,0,13560,53466,17,75,198,1050,19.8,78.1,0,0.1,0.3,1.5
E08000015,WIRRAL,159430,159375,98.8,87.1,87.1,79.9,87.1,0,0.1,0.1,1.1,0,99.8,0,157562,138937,138936,127383,138937,53,101,204,1813,2,159101,0,18626,138936,53,48,103,1609,11.7,87.1,0,0,0.1,1
E07000217,WOKING,45888,45830,98.5,86,83,13.2,80.5,0,0.3,0.3,1.4,0,99.2,0,45191,39448,38098,6072,36953,1,143,158,639,6,45526,0,7093,38098,1,142,15,481,15.5,83,0,0.3,0,1
E06000041,WOKINGHAM,77292,77069,97.6,80.8,78.4,33.1,76.9,0,0.1,0.4,2.2,0,98.6,0,75404,62437,60608,25585,59400,10,78,282,1665,10,76195,0,14796,60608,10,68,204,1383,19.1,78.4,0,0.1,0.3,1.8
E08000031,WOLVERHAMPTON,119592,119440,98.7,94.5,93.5,60.9,93,0,0,0,1.2,0,98.9,5,118052,113038,111850,72857,111177,1,2,50,1388,1,118259,5931,6202,111850,1,1,48,1338,5.2,93.5,0,0,0,1.1
E07000237,WORCESTER,49551,49486,99.3,75.7,72.7,69.8,69.8,0,0,0,0.6,0,99.5,0,49184,37528,36013,34582,34582,0,0,2,302,0,49312,0,13171,36013,0,0,2,300,26.6,72.7,0,0,0,0.6
E07000229,WORTHING,52163,52144,99.6,96.9,96.7,88.8,96.5,0,0,0,0.3,0,99.9,0,51967,50538,50438,46308,50353,0,1,7,177,1,52116,0,1529,50438,0,1,6,170,2.9,96.7,0,0,0,0.3
W06000006,WREXHAM,66829,66176,96,56.2,55.7,55.2,55.2,0.2,0.6,1.3,3,0.6,97.8,43.1,64171,37570,37197,36894,36895,132,434,843,2005,423,65374,28830,26974,37197,132,302,409,1162,40.4,55.7,0.2,0.5,0.6,1.7
E07000238,WYCHAVON,64378,64205,96.2,52.4,49.5,48.4,49.4,0.1,0.4,0.8,3.6,0.1,99.3,0,61909,33724,31851,31187,31790,53,263,487,2296,66,63959,1,30058,31851,53,210,224,1809,46.7,49.5,0.1,0.3,0.3,2.8
E07000128,WYRE,58322,58243,97.3,60.8,60.8,60.8,60.8,0.1,0.3,0.5,2.6,0,99,7.8,56743,35480,35477,35450,35480,54,152,280,1500,24,57742,4557,21266,35477,54,98,128,1220,36.5,60.8,0.1,0.2,0.2,2.1
E07000239,WYRE FOREST,49121,49027,97.8,63.8,63.8,25.7,63.8,0.1,0.2,0.4,2,0.1,99.6,3.4,48048,31340,31340,12612,31340,45,115,202,979,52,48916,1669,16708,31340,45,70,87,777,34,63.8,0.1,0.1,0.2,1.6
E06000014,YORK,96725,96582,95.4,80.6,78.4,65.9,76.3,0,0.1,0.5,4.4,0,96.9,21.8,92312,78000,75825,63736,73780,43,142,465,4270,16,93763,21109,16487,75825,43,99,323,3805,17,78.4,0,0.1,0.3,3.9
